Hello, and welcome to Dungeon Quest! To bring this message back up in the future, type help.

Here are some commands to get you started.
go [cardinal direction] - Allows you to travel to a room in the specified cardinal direction.
look - Allows you to obtain a description of the room.
look at [something] - Allows you to examine something more closely.
take [something] - Allows you to put an item into your inventory.
inventory - Allows you to view the items in your possession.
talk to [someone] - Allows you to speak with a non-playable character.

There are other supported actions that you will come across during the game. Try out anything that comes to mind!

Dungeon Quest
An Interactive Fiction by Alexander Garcia, Christopher Peterson, and Ziwei Wu
Release 1 / Serial number 210603 / Inform 7 build 6M62 (I6/v6.33 lib 6/12N) SD

Central Room
A rather barren room. You see a wizard at the north end next to what appears to be an exit. There are archways to your south, east, and west that seem to lead to rooms.

You can see a Wizard here.

>take table
That's fixed in place.

>take tray
Taken.

>i
You are carrying:
  the potion tray
    a red vial
    a yellow vial
    a blue vial
    a white vial
    a black vial
    a clear vial

* * *

>take tray
That's fixed in place.

>go north
Central Room
A rather barren room. You see a wizard at the north end next to what appears to be an exit.

>go west
Challenge Room 2 South
You find yourself in a damp and smelly room; the air suffocates you. To the east is an open doorway that leads to an open area. To the west is a door to what looks like a closet.

To the north, there are man-eating vines that block a trench. There appears to be something shiny on the other side. The walls are lined with torches for light. And in the middle of the room stands a janitor feeding raw chicken to the vines.

>go east
Central Room

>go east
Challenge Room 3
You enter a room filled with a variety of objects. A sense of dread comes over you as you look around. Where should you start?

You can see an old chest (closed), an old table (on which are jagged stone, a suspicious pair of glasses, a rubber band and a strange potion), a Y-shaped wooden stick, a stack of boulders, a magical staff, a suspended net, a broken wall and Ghost here.

Voice: "Here there! You probably can't see me as I'm a ghost, but my name's Casper! I was stuck in this room and died. Now that I have loads of free time, I figured out the puzzle. Or at least I think I did. Talk to me if you need any pointers!"

>take chest
That's fixed in place.

>take boulders
That's fixed in place.

>lift boulders
The stack of boulders seems to be too heavy for you to lift by hand.

* * *

>go north
You feel a strong force repel you away from the exit.

>go east
Challenge Room 3
You enter a room filled with a variety of objects. A sense of dread comes over you as you look around. Where should you start?

You can see an old chest (closed), an old table (on which are jagged stone, a suspicious pair of glasses, a rubber band and a strange potion), a Y-shaped wooden stick, a stack of boulders, a magical staff, a suspended net, a broken wall and Ghost here.

Voice: "Here there! You probably can't see me as I'm a ghost, but my name's Casper! I was stuck in this room and died. Now that I have loads of free time, I figured out the puzzle. Or at least I think I did. Talk to me if you need any pointers!"

>take stack of boulders
The stack of boulders seems to be too heavy for you to lift by hand.

* * *

>take boulders
The stack of boulders seems to be too heavy for you to lift by hand.

>take boulders
Despite your best efforts, you are unable to lift the stack of boulders.

* * *

>go north
You feel a strong force repel you away from the exit.

>go west
Challenge Room 2 South
You find yourself in a damp and smelly room; the air suffocates you. To the east is an open archway that leads to an open area. To the west is a door to what looks like a closet.

To the north, there are man-eating vines that block a trench. There appears to be something shiny on the other side. The walls are lined with torches for light. And in the middle of the room stands a janitor feeding raw chicken to the vines.

>go east
Central Room
A rather barren room. You see a wizard at the north end next to what appears to be an exit. There are archways to your south, east, and west that seem to lead to rooms.

You can see a Wizard here.

>go east
Challenge Room 3
You enter a room filled with a variety of objects. A sense of dread comes over you as you look around. Where should you start? To the west is an open archway that leads to an open area.

You can see an old chest (closed), an old table (on which are a jagged stone, a suspicious pair of glasses, a rubber band and a strange potion), a Y-shaped wooden stick, a stack of boulders, a magical staff, a suspended net, a broken wall and Ghost here.

Voice: "Here there! You probably can't see me as I'm a ghost, but my name's Casper! I was stuck in this room and died. Now that I have loads of free time, I figured out the puzzle. Or at least I think I did. Talk to me if you need any pointers!"

>combine band and stick
You can't use multiple objects with that verb.

>combine band with stick
(first taking the rubber band)
(first taking the Y-shaped wooden stick)
You now have a slingshot.

>use slingshot
(on the slingshot)
You picked up a nearby rock and shot the slingshot. The slingshot does not appear to be damaged.

>look
Challenge Room 3
The room is filled with a variety of objects. A sense of dread comes over you as you look around. Where should you start? To the west is an open archway that leads to an open area.

You can see an old chest (closed), an old table (on which are a jagged stone, a suspicious pair of glasses and a strange potion), a stack of boulders, a magical staff, a suspended net, a broken wall and Ghost here.

>use slingshot on hook
You picked up a nearby rock and shot the slingshot. The slingshot does not appear to be damaged.

>use slingshot on net
You picked up a nearby rock and shot the slingshot. The slingshot does not appear to be damaged.

>use slingshot
(on the slingshot)
You picked up a nearby rock and shot the slingshot. The slingshot does not appear to be damaged.

* * *

>go south
Challenge Room 1
You find yourself in a strange room. There is an open archway on the north side of the room, which seems to lead to an open area.

In this room, you see a table with a tray on it. Inside the tray are vials containing red, yellow, blue, black, white, and clear potions. Also on the table is a beaker and a recipe book. To the right is a stone encasing with a broken vial on the floor near it. There seems to be a human head popping out of the stone...

>wear glasses
You can't see any such thing.

>go north
Central Room

>go west
Challenge Room 2 South
You find yourself in a damp and smelly room; the air suffocates you. To the east is an open doorway that leads to an open area. To the west is a door to what looks like a closet.

To the north, there are man-eating vines that block a trench. There appears to be something shiny on the other side. The walls are lined with torches for light. And in the middle of the room stands a janitor feeding raw chicken to the vines.

* * *

>wear glasses
(first taking the suspicious pair of glasses)
There now appears to be a key on the old table.

>take key
Taken.

* * *

>look at chest
An old chest that looks like it might contain a pirate's treasure.

In the old chest is broken stone.

* * *

>go south
Challenge Room 1
You find yourself in a strange room. There is an open archway on the north side of the room, which seems to lead to an open area.

In this room, you see a table with a tray on it. Inside the tray are vials containing red, yellow, blue, black, white, and clear potions. Also on the table is a beaker and a recipe book. To the right is a stone encasing with a broken vial on the floor near it. There seems to be a human head popping out of the stone...

>talk to stone encasing
NPC: Urg, ah! Oh hey, didn't notice you there. Can you help me out here? I tried to make a new potion and I've gotten my entire body turned to stone! Luckily, it hasn't turned my head to stone. You see those vials on the table there? If you can make the correct potion and pour it on me, it should turn me back to normal! I don't remember how to make it, but the recipe book on the table should tell you how.

>talk to stone encasing
Stone-Encased Man: Didn't you hear me clearly? Look over there at the table. Do you see those vials? Mix the correct ones together into a stone-dissolving potion and pour it over me!

>look at book
The recipe book contains several recipes scribbled into it. 

 Cure grey hair = black + white 
 Madness potion = red + black 
 Dissolve stone = blue + red 
 Become invisible = yellow + blue 
 ??? = clear + anything 
 Injury cure = black + blue

>read
What do you want to read?

>read book
The recipe book contains several recipes scribbled into it. 

 Cure grey hair = black + white 
 Madness potion = red + black 
 Dissolve stone = blue + red 
 Become invisible = yellow + blue 
 ??? = clear + anything 
 Injury cure = black + blue

>talk to stone
You can't see any such thing.

>talk to stone encasing
Stone-Encased Man: Well, did you find the correct recipe?

>talk to stone encasing
Stone-Encased Man: Well, did you find the correct recipe?

>mix blue and red
You can't use multiple objects with that verb.

>mix blue with red
You now have a stone-dissolving potion.

>talk to stone
You can't see any such thing.

>talk to stone encasing
Stone-Encased Man: I think you've done it! That potion smells awful… Now hurry up and pour it on me so I can be free!

>pour stone-dissolving potion on npc
The stone-dissolving potion turns the NPC's stone-encased body back to normal.
NPC: That seems to have done the trick. Thank you for helping me out! It looks like the gem you need fell out of the rock, here you go. 
You received the red gem.

* * *

>go south
Challenge Room 1
You find yourself in a strange room. There is an open archway on the north side of the room, which seems to lead to an open area.

In this room, you see a table with a tray on it. Inside the tray are vials containing red, yellow, blue, black, white, and clear potions. Also on the table is a beaker and a recipe book. To the right is a stone encasing with a broken vial on the floor near it. There seems to be a human head popping out of the stone...

>mix red with yellow
There is now a suspicious potion sitting in the beaker.

>i
You are carrying nothing.

* * *

>look at beaker
A glass beaker used to safely mix potions. Magically enhanced to withstand whatever dangerous substances you may pour into it.

>mix red with yellow
There is now a suspicious potion sitting in the beaker.

>mix red with red
There is no space in the beaker for a new potion.

* * *

>go south
Challenge Room 1
You find yourself in a strange room. There is an open archway on the north side of the room, which seems to lead to an open area.

In this room, you see a table with a tray on it. Inside the tray are vials containing red, yellow, blue, black, white, and clear potions. Also on the table is a beaker and a recipe book. To the right is a stone encasing with a broken vial on the floor near it. There seems to be a human head popping out of the stone...

>mix red and red
You can't use multiple objects with that verb.

>mix red with red
There is now a suspicious potion sitting in the beaker.

>dump beaker
The potion fizzled away.

>mix red with red
There is now a suspicious potion sitting in the beaker.

>look at beaker
A glass beaker used to safely mix potions. Magically enhanced to withstand whatever dangerous substances you may pour into it.

In the beaker is a suspicious potion.

* * *

>dump beaker
The potion fizzled away.

>dump potion tray
The the potion tray can't be dumped.

* * *

>go south
Challenge Room 1
You find yourself in a strange room. There is an open archway on the north side of the room, which seems to lead to an open area.

In this room, you see a table with a tray on it. Inside the tray are vials containing red, yellow, blue, black, white, and clear potions. Also on the table is a beaker and a recipe book. To the right is a stone encasing with a broken vial on the floor near it. There seems to be a human head popping out of the stone...

>mix red with red
There is now a suspicious potion sitting in the beaker.

>take beaker
Taken.

>dump beaker
a

>mix red with blue
There is now a stone-dissolving potion sitting in the beaker.

>dump beaker
a

* * *

>mix red with red
There is now a suspicious potion sitting in the beaker.

>use beaker on stone
You cannot use beaker on Stone Encased Man.

* * *

>mix red with red
There is now a suspicious potion sitting in the beaker.

>use beaker on man
The suspicious potion had no effect.
Stone Encased Man: "AH! What are you doing?! I… Were you trying to help me? I guess I should be grateful, but you've got the wrong potion. You need to pour the correct potion on me to release me. The recipe book on the table there should point you in the right direction."

>mix red with red
There is no space in the beaker for a new potion.

* * *

>use beaker on man
The suspicious potion had no effect.
Stone Encased Man: "AH! What are you doing?! I… Were you trying to help me? I guess I should be grateful, but you've got the wrong potion. You need to pour the correct potion on me to release me. The recipe book on the table there should point you in the right direction."

>i
You are carrying nothing.

>mix red with red
There is now a suspicious potion sitting in the beaker.

>use suspicious potion on man
The suspicious potion had no effect.
Stone Encased Man: "*sputters* Ah! It didn't work!"

>mix red with blue
There is now a stone-dissolving potion sitting in the beaker.

>use beaker on man
The suspicious potion had no effect.
Stone Encased Man: "*sputters* Ah! It didn't work!"

* * *

>go south
Challenge Room 1
You find yourself in a strange room. There is an open archway on the north side of the room, which seems to lead to an open area.

In this room, you see a table with a tray on it. Inside the tray are vials containing red, yellow, blue, black, white, and clear potions. Also on the table is a beaker and a recipe book. To the right is a stone encasing with a broken vial on the floor near it. There seems to be a human head popping out of the stone...

>brew red and red
You can't use multiple objects with that verb.

>go north
Central Room

>go south
Challenge Room 1
In this room, you see a table with a tray on it. Inside the tray are vials containing red, yellow, blue, black, white, and clear potions. Also on the table is a beaker and a recipe book. To the right is a stone encasing with a broken vial on the floor near it.

>talk to npc
You can't see any such thing.

>empty beaker
The potion fizzled away.

* * *

>go south
Challenge Room 1
You find yourself in a strange room. There is an open archway on the north side of the room, which seems to lead to an open area.

In this room, you see a table with a tray on it. Inside the tray are vials containing red, yellow, blue, black, white, and clear potions. Also on the table is a beaker and a recipe book. To the right is a stone encasing with a broken vial on the floor near it. There seems to be a human head popping out of the stone...

>empty beaker
The beaker is alread empty.

>grab
That's not a verb I recognise.

* * *

>go south
Challenge Room 1
You find yourself in a strange room. There is an open archway on the north side of the room, which seems to lead to an open area.

In this room, you see a table with a tray on it. Inside the tray are vials containing red, yellow, blue, black, white, and clear potions. Also on the table is a beaker and a recipe book. To the right is a stone encasing with a broken vial on the floor near it. There seems to be a human head popping out of the stone...

>read book
The recipe book contains several recipes scribbled into it. 

Cure grey hair: mix black vial with white vial
Madness potion: mix red vial with black 
Dissolve stone: mix blue vial with red vial
Become invisible: mix yellow vial with blue vial
Colored water: mix clear vial with any vial 
Injury cure: mix black vial with blue vial

>fly
What do you want to fly on?

>broom
You can't see any such thing.

>fly north
I didn't understand that sentence.

>go north
Central Room

* * *

>go west
Challenge Room 2 South
You find yourself in a damp and smelly room; the air suffocates you. To the east is an open doorway that leads to an open area. To the west is a door to what looks like a closet.

To the north, there are man-eating vines that block a trench. There appears to be something shiny on the other side. The walls are lined with torches for light. And in the middle of the room stands a janitor feeding raw chicken to the vines.

>craft
What do you want to craft?

>stick
You can't see any such thing.

>go east
Central Room

>go east
Challenge Room 3
You enter a room filled with a variety of objects. A sense of dread comes over you as you look around. Where should you start?

You can see an old chest (closed), an old table (on which are jagged stone, a suspicious pair of glasses, a rubber band and a strange potion), a Y-shaped wooden stick, a stack of boulders, a magical staff, a suspended net, a broken wall (empty) and Ghost here.

Voice: "Here there! You probably can't see me as I'm a ghost, but my name's Casper! I was stuck in this room and died. Now that I have loads of free time, I figured out the puzzle. Or at least I think I did. Talk to me if you need any pointers!"

>craft
What do you want to craft?

>stick
What do you want to craft the Y-shaped wooden stick with?

>band
(first taking the Y-shaped wooden stick)
(first taking the rubber band)
You now have a slingshot.

* * *

>go south
Challenge Room 1
You find yourself in a strange room. There is an open archway on the north side of the room, which seems to lead to an open area.

In this room, you see a table with a tray on it. Inside the tray are vials containing red, yellow, blue, black, white, and clear potions. Also on the table is a beaker and a recipe book. To the right is a stone encasing with a broken vial on the floor near it. There seems to be a human head popping out of the stone...

>look
Challenge Room 1
You find yourself in a strange room. There is an open archway on the north side of the room, which seems to lead to an open area.

In this room, you see a table with a tray on it. Inside the tray are vials containing red, yellow, blue, black, white, and clear potions. Also on the table is a beaker and a recipe book. To the right is a stone encasing with a broken vial on the floor near it. There seems to be a human head popping out of the stone...

>talk
(to Stone-Encased Man)
Stone-Encased Man: "Urg, ah! Oh hey, didn't notice you there. Can you help me out here? I tried to make a new potion and I've gotten my entire body turned to stone! Luckily, it hasn't turned my head to stone. You see those vials on the table there? If you can make the correct potion and pour it on me, it should turn me back to normal! I don't remember how to make it, but the recipe book on the table should tell you how."

>talk
(to Stone-Encased Man)
Stone-Encased Man: "Didn't you hear me clearly? Look over there at the table. Do you see those vials? You should mix the correct ones together into a stone-dissolving potion and pour it over me!"

>mix
What do you want to mix?

>red and blue
You can't use multiple objects with that verb.

>talk
(to Stone-Encased Man)
Stone-Encased Man: "Didn't you hear me clearly? Look over there at the table. Do you see those vials? You should mix the correct ones together into a stone-dissolving potion and pour it over me!"

>read book
The recipe book contains several recipes scribbled into it. 

Cure grey hair: mix black vial with white vial
Madness potion: mix red vial with black 
Dissolve stone: mix blue vial with red vial
Become invisible: mix yellow vial with blue vial
Colored water: mix clear vial with any vial 
Injury cure: mix black vial with blue vial

>mix red vial with blue vial
There is now a stone-dissolving potion sitting in the beaker.

>talk
(to Stone-Encased Man)
Stone-Encased Man: "I think you've done it! That potion smells awful… Now hurry up and pour it on me so I can be free!"

>pour
What do you want to pour?

>potion
Which do you mean, the potion tray or the stone-dissolving potion?

>stone-dissolving potion
What do you want to pour the stone-dissolving potion on?

>stone-encased man
The stone-dissolving potion turns the Stone-Encased Man's body back to normal.
Stone-Encased Man: "That seems to have done the trick. Thank you for helping me out! It looks like a valuable gem fell out of the rock, here you go."
You received the red gem.

* * *

>go south
Challenge Room 1
You find yourself in a strange room. There is an open archway on the north side of the room, which seems to lead to an open area.

In this room, you see a table with a tray on it. Inside the tray are vials containing red, yellow, blue, black, white, and clear potions. Also on the table is a beaker and a recipe book. To the right is a stone encasing with a broken vial on the floor near it. There seems to be a human head popping out of the stone...

>mix red and blue
You can't use multiple objects with that verb.

>mix red with blue
There is now a stone-dissolving potion sitting in the beaker.

>pour beaker on man
The stone-dissolving potion turns the Stone-Encased Man's body back to normal.
Stone-Encased Man: "AH! What are you doing?! Wait… I'm free! Thank you! But I would've preferred if you had given me a warning first."
The red gem, freed from the stone encasing, falls to the ground. You pick up the red gem.

* * *

>mix red with blue
There is now a stone-dissolving potion sitting in the beaker.

>use potion on man
The stone-dissolving potion turns the Stone Encased Man's body back to normal.
Stone Freed Man: "AH! What are you doing?! Wait… I'm free! Thank you! But I would've preferred if you had given me a warning first."
The red gem, freed from the stone encasing, falls to the ground. You pick up the red gem.

>go north
Central Room
A rather barren room. You see a wizard at the north end next to what appears to be an exit. There are archways to your south, east, and west that seem to lead to rooms.

You can see a Wizard here.

>go east
Challenge Room 3
You enter a room filled with a variety of objects. A sense of dread comes over you as you look around. Where should you start? To the west is an open archway that leads to an open area.

You can see an old chest (closed), an old table (on which are a jagged stone, a suspicious pair of glasses, a rubber band and a strange elixir), a Y-shaped wooden stick, a stack of boulders, a magical staff, a suspended net, a broken wall and Ghost here.

Voice: "Here there! You probably can't see me as I'm a ghost, but my name's Casper! I was stuck in this room and died. Now that I have loads of free time, I figured out the puzzle. Or at least I think I did. Talk to me if you need any pointers!"

>place jagged in wall
The jagged stone seemed to fit perfectly into the broken wall. You hear a faint clicking sound.

>wear glasses
(first taking the suspicious pair of glasses)
There is a strange aura coming from these glasses. When you put them on, a key appears on the old table.

>unlock chest with key
(first taking the invisible key)
In the old chest is a broken stone.

>place broken stone in wall
The broken stone seemed to fit perfectly into the broken wall. You hear a faint clicking sound.

>combine stick with band
(first taking the Y-shaped wooden stick)
(first taking the rubber band)
You now have a slingshot.

>shoot net with slingshot
You picked up a nearby rock and shot the suspended net. The suspended net plummeted to the ground, along with a stone slab.

>place slab in wall
The stone slab seemed to fit perfectly into the broken wall. You hear a faint clicking sound.

>drink elixir
You are now exuding a strange magical aura. It feels as if you can now lift things with ease.

>lift boulders with staff
You channeled your newfound aura into the staff. To your surprise, the stack of boulders began to float in the air. Behind the stack of boulders was a stone shard. You moved the stack of boulders to the side, allowing access to the stone shard.

>take shard
Taken.

>place shard in wall
The stone shard seemed to fit perfectly into the broken wall. You hear a faint clicking sound.
With that last piece, you hear a strange sound behind you. You see a pedestal rising up from the ground, holding a blue gem.

>take gem
(the blue gem)
Taken.

>go west
Central Room
A rather barren room. You see a wizard at the north end next to what appears to be an exit. There are archways to your south, east, and west that seem to lead to rooms.

You can see a Wizard here.

>go west
Challenge Room 2 South
You find yourself in a damp and smelly room; the air suffocates you. To the east is an open archway that leads to an open area. To the west is a door to what looks like a closet.

To the north, there are man-eating vines that block a trench. There appears to be something shiny on the other side. The walls are lined with torches for light. And in the middle of the room stands a janitor feeding raw chicken to the vines.

>use torch on vines
Janitor: Hey, what are you doing?! Get out of there before you get burned as well!
The man-eating vines has been burnt to a crisp.

>go west
Supply Closet
There are a variety of cleaning supplies in this room. To the east is a door leading back to the musty room.

You can see the suspicious broom here.

>take broom
Taken.

>go east
Challenge Room 2 South
You find yourself in a damp and smelly room; the air suffocates you. To the east is an open archway that leads to an open area. To the west is a door to what looks like a closet.

There is a trench to the north. There appears to be something shiny on the other side. The walls are lined with torches for light. And in the middle of the room stands a janitor cleaning up the mess left by the vines.

>fly on broom
Challenge Room 2 North
The air seems to be fresher here.

An expensive-looking pedestal sits in the middle of the room. A yellow gem sits on top of it. To the south is the trench that you flew over, leading to the exit.

You have flown into the north side of the room.

>take gem
(the yellow gem)
Taken.

>fly on broom
Challenge Room 2 South
You find yourself in a damp and smelly room; the air suffocates you. To the east is an open archway that leads to an open area. To the west is a door to what looks like a closet.

There is a trench to the north. There appears to be something shiny on the other side. The walls are lined with torches for light. And in the middle of the room stands a janitor cleaning up the mess left by the vines.

You have flown into the south side of the room.

>go east
Central Room
A rather barren room. You see a wizard at the north end next to what appears to be an exit. There are archways to your south, east, and west that seem to lead to rooms.

You can see a Wizard here.

>go north
Wizard: "You're just going to ignore me to the end? How rude. Go leave if that's what you want to do."

    *** The End ***

Would you like to RESTART, RESTORE a saved game, QUIT or UNDO the last command?

* * *

>mix red and blue
You can't use multiple objects with that verb.

>mix red with bleu
You can't see any such thing.

>mix red with blue
There is now a stone-dissolving potion sitting in the beaker.

>take potion
I better avoid touching this directly.

>i
You are carrying nothing.

>take beaker
Taken.

>i
You are carrying:
  a beaker
    a stone-dissolving potion

>talk to human
Stone Encased Man: "Urg, ah! Oh hey, didn't notice you there. Can you help me out here? I tried to make a new potion and I've gotten my entire body turned to stone! Luckily, it hasn't turned my head to stone… Wait, you've got the right potion! Quick -- pour it on me!"

>help
Here are some commands to get you started.
go [cardinal direction] - Allows you to travel to a room in the specified cardinal direction.
look - Allows you to obtain a description of the room.
look at [something] - Allows you to examine something more closely.
take [something] - Allows you to put an item into your inventory.
inventory - Allows you to view the items in your possession.
talk to [someone] - Allows you to speak with a non-playable character.

There are other supported actions that you will come across during the game. Try out anything that comes to mind! To bring this message back up in the future, type help.

* * *

>go south
Challenge Room 1
You find yourself in a strange room. There is an open archway on the north side of the room, which seems to lead to an open area.

In this room, you see a table with a tray on it. Inside the tray are vials containing red, yellow, blue, black, white, and clear potions. Also on the table is a beaker and a recipe book. To the right is a stone encasing with a broken vial on the floor near it. There seems to be a human head popping out of the stone...

>dump beaker
The beaker is already empty.

>mix red and red
You can't use multiple objects with that verb.

* * *

>go south
Challenge Room 1
You find yourself in a strange room. There is an open archway on the north side of the room, which seems to lead to an open area.

In this room, you see a table with a tray on it. Inside the tray are vials containing red, yellow, blue, black, white, and clear potions. Also on the table is a beaker and a recipe book. To the right is a stone encasing with a broken vial on the floor near it. There seems to be a human head popping out of the stone...

>talk to stone
Stone Encased Man: "Urg, ah! Oh hey, didn't notice you there. Can you help me out here? I tried to make a new potion and I've gotten my entire body turned to stone! Luckily, it hasn't turned my head to stone. You see those vials on the table there? If you can make the correct potion and pour it on me, it should turn me back to normal! I don't remember how to make it, but the recipe book on the table should tell you how."

* * *

>go south
Challenge Room 1
You find yourself in a strange room. There is an open archway on the north side of the room, which seems to lead to an open area.

In this room, you see a table with a tray on it. Inside the tray are vials containing red, yellow, blue, black, white, and clear potions. Also on the table is a beaker and a recipe book. To the right is a stone encasing with a broken vial on the floor near it. There seems to be a human head popping out of the stone...

>mix red with blue
There is now a stone-dissolving potion sitting in the beaker.

>pour potion on stone
Which do you mean, the potion tray or the stone-dissolving potion?

>stone-dissolving potion
The stone-dissolving potion turns the Stone Encased Man's body back to normal.
Stone Freed Man: "AH! What are you doing?! Wait… I'm free! Thank you! But I would've preferred if you had given me a warning first."
The red gem, freed from the stone encasing, falls to the ground. You pick up the red gem.

* * *

>mix red with blue
There is now a stone-dissolving potion sitting in the beaker.

>pour purple on stone
The stone-dissolving potion turns the Stone Encased Man's body back to normal.
Stone Freed Man: "AH! What are you doing?! Wait… I'm free! Thank you! But I would've preferred if you had given me a warning first."
The red gem, freed from the stone encasing, falls to the ground. You pick up the red gem.

>drop red gem
This gem looks valuable. I should probably hold on to it.

>go north
Central Room
A rather barren room. You see a wizard at the north end next to what appears to be an exit. There are archways to your south, east, and west that seem to lead to rooms.

You can see a Wizard here.

>go west
Challenge Room 2 South
You find yourself in a damp and smelly room; the air suffocates you. To the east is an open archway that leads to an open area. To the west is a door to what looks like a closet.

To the north, there are man-eating vines that block a trench. There appears to be something shiny on the other side. The walls are lined with torches for light. And in the middle of the room stands a janitor feeding raw chicken to the vines.

>burn vines with torch
Janitor: Hey, what are you doing?! Get out of there before you get burned as well!
The man-eating vines has been burnt to a crisp.

>go west
Supply Closet
There are a variety of cleaning supplies in this room. To the east is a door leading back to the musty room.

You can see the suspicious broom here.

* * *

>go east
Challenge Room 2 South
You find yourself in a damp and smelly room; the air suffocates you. To the east is an open archway that leads to an open area. To the west is a door to what looks like a closet.

There is a trench to the north. There appears to be something shiny on the other side. The walls are lined with torches for light. And in the middle of the room stands a janitor cleaning up the mess left by the vines.

>talk to janitor
Janitor: "Hey, how are you? You shouldn't be wondering around here. Well, not that the vines are gone, I guess you can look around if you want to. Looks like there's a trench between us and that orb over there. Maybe you can use that broom to fly over it."

>fly
What do you want to fly on?

>broom
Challenge Room 2 North
The air seems to be fresher here.

An expensive-looking pedestal sits in the middle of the room. A yellow gem sits on top of it. To the south is the trench that you flew over, leading to the exit.

You have flown into the north side of the room.

>take yellow
(the yellow pedestal)
That's fixed in place.

>take yellow gem
Taken.

>go south
Challenge Room 2 South
You find yourself in a damp and smelly room; the air suffocates you. To the east is an open archway that leads to an open area. To the west is a door to what looks like a closet.

There is a trench to the north. There appears to be something shiny on the other side. The walls are lined with torches for light. And in the middle of the room stands a janitor cleaning up the mess left by the vines.

>go north
There is no feasible way to get across this trench.

* * *

>mix red with blue
There is now a stone-dissolving potion sitting in the beaker.

>use purple on stone
The stone-dissolving potion turns the Stone Encased Man's body back to normal.
Stone Freed Man: "AH! What are you doing?! Wait… I'm free! Thank you! But I would've preferred if you had given me a warning first."
The red gem, freed from the stone encasing, falls to the ground. You pick up the red gem.

>go north
Central Room
A rather barren room. You see a wizard at the north end next to what appears to be an exit. There are archways to your south, east, and west that seem to lead to rooms.

You can see a Wizard here.

* * *

>take gem
(the yellow gem)
Taken.

>go south
The trench is deep. It would be best to fly on the broom to get across.

>fly on broom
Challenge Room 2 South
You find yourself in a damp and smelly room; the air suffocates you. To the east is an open archway that leads to an open area. To the west is a door to what looks like a closet.

There is a trench to the north. There appears to be something shiny on the other side. The walls are lined with torches for light. And in the middle of the room stands a janitor cleaning up the mess left by the vines.

You have flown into the south side of the room.

* * *

>go east
Central Room
A rather barren room. You see a wizard at the north end next to what appears to be an exit. There are archways to your south, east, and west that seem to lead to rooms.

You can see a Wizard here.

>go east
Challenge Room 3
You enter a room filled with a variety of objects. A sense of dread comes over you as you look around. Where should you start? To the west is an open archway that leads to an open area.

You can see an old chest (closed), an old table (on which are jagged stone, a suspicious pair of glasses, a rubber band and a strange potion), a Y-shaped wooden stick, a stack of boulders, a magical staff, a suspended net, broken wall and Ghost here.

Voice: "Here there! You probably can't see me as I'm a ghost, but my name's Casper! I was stuck in this room and died. Now that I have loads of free time, I figured out the puzzle. Or at least I think I did. Talk to me if you need any pointers!"

>take jagged stone
Taken.

>talk to casper
Casper: "I wonder what you're planning on doing with that jagged stone. It's definitely shaped pretty weirdly though, like it broke off from somewhere."

>look at broken wall
A wall that appears to have several holes in it. It looks like there are four places that something may fit into.

>talk to casper
Casper: "That stone might fit into that broken wall you saw earlier. You should try to place it into the wall!"

>place
What do you want to place?

>jagged stone
What do you want to place jagged stone in?

>broken wall
The jagged stone seemed to fit perfectly into the broken wall. You hear a faint clicking sound.

>talk to casper
Casper: "Great, that fit perfectly!"

>talk to casper
Casper: "Maybe something on that table can help you out."

>look at table
A nice, sturdy table made of wood. You knock on it for good luck.

On the old table are a suspicious pair of glasses, a rubber band and a strange potion.

>wear glasses
(first taking the suspicious pair of glasses)
There is a strange aura coming from these glasses. When you put them on, a key appears on the old table.

>take band
Taken.

>take key
Taken.

>drink potion
You are now exuding a strange magical aura. It feels as if you can now lift things with ease.

>combine band with stick
(first taking the Y-shaped wooden stick)
You now have a slingshot.

>talk to casper
Casper: "Great work crafting that slingshot! You should be able to shoot down something in here... Look around!"

>look at net
An unreachable net that holds a stone slab. The net is hanging from a rotting wooden hook.

>talk to casper
Casper: "You saw that suspended net, right? It looks really weak! I'm sure you could shoot it down using your slingshot."

>shoot net
What do you want to shoot the suspended net with?

>slingshot
You picked up a nearby rock and shot the suspended net. The suspended net plummeted to the ground, along with a stone slab.

>take stone slab
Taken.

>unlock chest with key
In the old chest is a broken stone.

>take broken stone
Taken.

>look
Challenge Room 3
The room is filled with a variety of objects. A sense of dread comes over you as you look around. Where should you start? To the west is an open archway that leads to an open area.

You can see a torn net, an old chest (empty), an old table (on which is a lifting potion), a stack of boulders, a magical staff, broken wall and Ghost here.

>talk to casper
Casper: "Maybe you can place that useless rock into that broken wall from earlier."

>i
You are carrying:
  broken stone
  stone slab
  a slingshot
  an invisible key
  a suspicious pair of glasses (being worn)
  the yellow gem
  the suspicious broom
  a red gem

>place broken stone in wall
Which do you mean, broken wall, broken stone or stone slab?

>place broken stone in broken wall
The broken stone seemed to fit perfectly into the broken wall. You hear a faint clicking sound.

>place stone slab in broken wall
The stone slab seemed to fit perfectly into the broken wall. You hear a faint clicking sound.

>talk to casper
Casper: "Great, that fit perfectly!"

>talk to casper
Casper: "Great, that fit perfectly!"

>talk to casper
Casper: "Okay, you have the magical powers... But now you need a staff to channel those powers. I swear there was one lying around here somewhere..."

>take staff
Taken.

>talk to casper
Casper: "You have the staff and you drank the potion, right? Looks like you should be able to lift the boulders now! Try to lift it with the staff."

>lift boulders with staff
You channeled your newfound aura into the staff. To your surprise, the stack of boulders began to float in the air. Behind the stack of boulders was a stone shard. You moved the stack of boulders to the side, allowing access to the stone shard.

>take stone shard
Taken.

>place stone shard in broken wall
The stone shard seemed to fit perfectly into the broken wall. You hear a faint clicking sound.
With that last piece, you hear a strange sound behind you. You see a pedestal rising up from the ground, holding a blue gem.

>take blue gem
Taken.

>go east
You can't go that way.

>go west
Central Room
A rather barren room. You see a wizard at the north end next to what appears to be an exit. There are archways to your south, east, and west that seem to lead to rooms.

You can see a Wizard here.

>talk to wizard
Wizard: "Welcome to my magnificent escape room! You… already have all the gems. Well, how rude. You could have at least let me say my introduction. I worked very hard on it, you know!"

>talk to wizard
Wizard: "Go through the exit already! I promise you have more important things to get to right now."

* * *

>mix red with blue
There is now a stone-dissolving potion sitting in the beaker.

>use beaker on man
The suspicious potion had no effect.
Stone Encased Man: "AH! What are you doing?! I… Were you trying to help me? I guess I should be grateful, but you've got the wrong potion. You need to pour the correct potion on me to release me. The recipe book on the table there should point you in the right direction."

* * *

>mix red with blue
There is now a stone-dissolving potion sitting in the beaker.

>use potion on man
Which do you mean, the potion tray or the stone-dissolving potion?

>use stone-dissolving potion on man
The stone-dissolving potion turns the Stone Encased Man's body back to normal.
Stone Freed Man: "AH! What are you doing?! Wait… I'm free! Thank you! But I would've preferred if you had given me a warning first."
The red gem, freed from the stone encasing, falls to the ground. You pick up the red gem.

* * *

>mix red with blue
There is now a stone-dissolving potion sitting in the beaker.

>take potion
I better avoid touching this directly.

Taken.

>i
You are carrying nothing.

* * *

>go south
Challenge Room 1
You find yourself in a strange room. There is an open archway on the north side of the room, which seems to lead to an open area.

In this room, you see a table with a tray on it. Inside the tray are vials containing red, yellow, blue, black, white, and clear potions. Also on the table is a beaker and a recipe book. To the right is a stone encasing with a broken vial on the floor near it. There seems to be a human head popping out of the stone...

>talk to head
Stone Encased Man: "Urg, ah! Oh hey, didn't notice you there. Can you help me out here? I tried to make a new potion and I've gotten my entire body turned to stone! Luckily, it hasn't turned my head to stone. You see those vials on the table there? If you can make the correct potion and pour it on me, it should turn me back to normal! I don't remember how to make it, but the recipe book on the table should tell you how."

>look at head
It seems to be a man encased in stone. You can see a shiny red gem around where his belly-button would be.

>go north
Central Room
A rather barren room. You see a wizard at the north end next to what appears to be an exit. There are archways to your south, east, and west that seem to lead to rooms.

You can see a Wizard here.

* * *

>go west
Challenge Room 2 South
You find yourself in a damp and smelly room; the air suffocates you. To the east is an open archway that leads to an open area. To the west is a door to what looks like a closet.

To the north, there are man-eating vines that block a trench. There appears to be something shiny on the other side. The walls are lined with torches for light. And in the middle of the room stands a janitor feeding raw chicken to the vines.

>use torch on vines
That's not a verb I recognise.

>use
That's not a verb I recognise.

* * *

>go south
Challenge Room 1
You find yourself in a strange room. There is an open archway on the north side of the room, which seems to lead to an open area.

In this room, you see a table with a tray on it. Inside the tray are vials containing red, yellow, blue, black, white, and clear potions. Also on the table is a beaker and a recipe book. To the right is a stone encasing with a broken vial on the floor near it. There seems to be a human head popping out of the stone...

>take black vial
Taken.

>brew red with blue
There is now a stone-dissolving potion sitting in the beaker.

>take potion
That's fixed in place.

* * *

>go east
Challenge Room 3
You enter a room filled with a variety of objects. A sense of dread comes over you as you look around. Where should you start? To the west is an open archway that leads to an open area.

You can see an old chest (closed), an old table (on which are a jagged stone, a suspicious pair of glasses, a rubber band and a strange elixir), a Y-shaped wooden stick, a stack of boulders, a magical staff, a suspended net, a broken wall and Ghost here.

Voice: "Here there! You probably can't see me as I'm a ghost, but my name's Casper! I was stuck in this room and died. Now that I have loads of free time, I figured out the puzzle. Or at least I think I did. Talk to me if you need any pointers!"

>wear glasses
(first taking the suspicious pair of glasses)
There is a strange aura coming from these glasses. When you put them on, a key appears on the old table.

>take key
Taken.

>unlock chest with key
In the old chest is a broken stone.

>take jagged stone
Taken.

>place jagged stone into broken wall
I didn't understand that sentence.

>place wall piece down into broken wall
I didn't understand that sentence.

* * *

>take key
Taken.

>place key in wall
The invisible key does not seem to fit in the broken wall.

>look at wall
A wall that appears to have several holes in it. It looks like there are four places that something may fit into.

* * *

>take jagged stone
Taken.

>place jagged stone into broken wall
The jagged stone seemed to fit perfectly into the broken wall. You hear a faint clicking sound.

* * *

>take jagged stone
Taken.

>wear glasses
(first taking the suspicious pair of glasses)
There is a strange aura coming from these glasses. When you put them on, a key appears on the old table.

* * *

>take broken stone
Taken.

>drink potion
You can't see any such thing.

>drink elixir
You are now exuding a strange magical aura. It feels as if you can now lift things with ease.

>take staff
Taken.

>lift boulders with staff
You channeled your newfound aura into the staff. To your surprise, the stack of boulders began to float in the air. Behind the stack of boulders was a stone shard. You moved the stack of boulders to the side, allowing access to the stone shard.

* * *

>take stone shard
Taken.

>combine stick with band
(first taking the Y-shaped wooden stick)
(first taking the rubber band)
You now have a slingshot.

>use slingshot on net
You picked up a nearby rock and shot the suspended net. The suspended net plummeted to the ground, along with a stone slab.

>take stone slab
Taken.

>place stone in wall
Which do you mean, the stone slab, the stone shard, the broken stone or the jagged stone?

>place slab in wall
The stone slab seemed to fit perfectly into the broken wall. You hear a faint clicking sound.

>place shard in wall
The stone shard seemed to fit perfectly into the broken wall. You hear a faint clicking sound.

>place jagged in wall
The jagged stone seemed to fit perfectly into the broken wall. You hear a faint clicking sound.

>place broken stone in wall
The broken stone seemed to fit perfectly into the broken wall. You hear a faint clicking sound.
With that last piece, you hear a strange sound behind you. You see a pedestal rising up from the ground, holding a blue gem.

>talk to casper
a

* * *

>take key
Taken.

>use key on chest
In the old chest is a broken stone.

>take stone
(the broken stone)
Taken.

>use elixir
There's nothing suitable to drink here.

>drink elixir
You are now exuding a strange magical aura. It feels as if you can now lift things with ease.

* * *

>take shard
Taken.

>combine stick and band
You can't use multiple objects with that verb.

>combine stick with band
(first taking the Y-shaped wooden stick)
(first taking the rubber band)
You now have a slingshot.

* * *

>shoot net with slingshot
You picked up a nearby rock and shot the suspended net. The suspended net plummeted to the ground, along with a stone slab.

>take slab
Taken.

>place slab in wall
The stone slab seemed to fit perfectly into the broken wall. You hear a faint clicking sound.

* * *

>place shard in wall
The stone shard seemed to fit perfectly into the broken wall. You hear a faint clicking sound.

>place broken stone in wall
The broken stone seemed to fit perfectly into the broken wall. You hear a faint clicking sound.

>place jagged in wall
The jagged stone seemed to fit perfectly into the broken wall. You hear a faint clicking sound.
With that last piece, you hear a strange sound behind you. You see a pedestal rising up from the ground, holding a blue gem.

>talk to casper
Casper: "You solved the puzzle!! Go pick up the gem already..."

>take gem
Taken.

>talk to casper
Casper: "What are you still doing here, you already have the gem! Oh, are you worried that I'll be lonely here? Don't worry, I've been alone for years now. I'll eventually find something to do."

* * *

>go west
Central Room
A rather barren room. You see a wizard at the north end next to what appears to be an exit. There are archways to your south, east, and west that seem to lead to rooms.

You can see a Wizard here.

>go west
Challenge Room 2 South
You find yourself in a damp and smelly room; the air suffocates you. To the east is an open doorway that leads to an open area. To the west is a door to what looks like a closet.

To the north, there are man-eating vines that block a trench. There appears to be something shiny on the other side. The walls are lined with torches for light. And in the middle of the room stands a janitor feeding raw chicken to the vines.

>go west
Supply Closet
You can see the suspicious broom here.

>fly on broom
You cannot fly in here.

>take broom
Taken.

>go east
Challenge Room 2 South
To the north, there are man-eating vines that block a trench. There appears to be something shiny on the other side. The walls are lined with torches for light. And in the middle of the room stands a janitor feeding raw chicken to the vines.

>fly on broom
You have flown into the south side of the room.

>look
Challenge Room 2 South
You find yourself in a damp and smelly room; the air suffocates you. To the east is an open doorway that leads to an open area. To the west is a door to what looks like a closet.

To the north, there are man-eating vines that block a trench. There appears to be something shiny on the other side. The walls are lined with torches for light. And in the middle of the room stands a janitor feeding raw chicken to the vines.

* * *

>go west
Central Room
A rather barren room. You see a wizard at the north end next to what appears to be an exit. There are archways to your south, east, and west that seem to lead to rooms.

You can see a Wizard here.

>go east
Challenge Room 3
The room is filled with a variety of objects. A sense of dread comes over you as you look around. Where should you start? To the west is an open archway that leads to an open area.

You can see an old chest (closed), an old table (on which are a jagged stone, a suspicious pair of glasses, a rubber band and a strange potion), a Y-shaped wooden stick, a stack of boulders, a magical staff, a suspended net, a broken wall and Ghost here.

* * *

>take stick
Taken.

>take band
Taken.

>craft stick and band
You must supply a second noun.
You must supply a second noun.

* * *

>take stick
Taken.

>talk to casper
Casper: "There should be a rubber band somewhere around here... You could definitely craft a slingshot if you picked it up and combined it with that Y-shaped stick you have."

>look
Challenge Room 3
The room is filled with a variety of objects. A sense of dread comes over you as you look around. Where should you start?

You can see an old chest (closed), an old table (on which are jagged stone, a suspicious pair of glasses, a rubber band and a strange potion), a stack of boulders, a magical staff, a suspended net, a broken wall and Ghost here.

>take suspended net
That's fixed in place.

>look at suspended net
An unreachable net that holds a wall piece. The net is hanging from a rotting wooden hook.

>talk to casper
Casper: "Looks like something fell out of the net... Go check it out, I'm sure it will be useful somewhere..."

* * *

>talk to casper
Casper: "There should be a rubber band somewhere around here... You could definitely craft a slingshot if you picked it up and combined it with that Y-shaped stick you have."

>combine stick with band
(first taking the rubber band)
You now have a slingshot.

>talk to casper
Casper: "Great work crafting that slingshot! You should be able to shoot down something in here... Look around!"

* * *

>look at net
An unreachable net that holds a stone slab. The net is hanging from a rotting wooden hook.

>shoot net
(with the slingshot)
You picked up a nearby rock and shot the suspended net. The suspended net plummeted to the ground, along with a stone slab.

>take slap
You can't see any such thing.

>take stone slab
Taken.

>talk to casper
Casper: "Looks like something fell out of the net... Go check it out, I'm sure it will be useful somewhere..."

>look at stone slab
A piece of stone that appears to have broken off from somewhere.

>talk to casper
Casper: "Looks like something fell out of the net... Go check it out, I'm sure it will be useful somewhere..."

* * *

>take stick
Taken.

>put stick in broken wall
There is no more room in the broken wall.

>put
(on the Y-shaped wooden stick)
You can't wear that!

* * *

>craft band and stick
check1
rubber band: (first taking the rubber band)
check2
check3
check4check1a1
Y-shaped wooden stick: That isn't available.

>craft band, stick
You must supply a second noun.
You must supply a second noun.

>craft
What do you want to craft?

>rubber band and y-shaped stick
You must supply a second noun.
You must supply a second noun.

* * *

>craft band and stick
check1
rubber band: (first taking the rubber band)
check2
check3
check4check1a1
Y-shaped wooden stick: That isn't available.

>look
Challenge Room 3
The room is filled with a variety of objects. A sense of dread comes over you as you look around. Where should you start?

You can see an old chest (closed), an old table (on which are jagged stone, a suspicious pair of glasses and a strange potion), a stack of boulders, a magical staff, a suspended net, a broken wall and Ghost here.

>i
You are carrying:
  a slingshot

* * *

>craft stick and band
check1
Y-shaped wooden stick: (first taking the Y-shaped wooden stick)
check2
check3
check4check1a1
rubber band: That isn't available.

>look
Challenge Room 3
The room is filled with a variety of objects. A sense of dread comes over you as you look around. Where should you start?

You can see an old chest (closed), an old table (on which are jagged stone, a suspicious pair of glasses and a strange potion), a stack of boulders, a magical staff, a suspended net, a broken wall and Ghost here.

>inventory
You are carrying:
  a slingshot

* * *

>craft stick and band
check1
Y-shaped wooden stick: (first taking the Y-shaped wooden stick)
check2
check3
check4check1a1
rubber band: That isn't available.

>craft
(the slingshot)
*** Couldn't read from entry 1 of a list which is empty ***

*** Run-time problem P50: Attempt to use list item which does not exist.

*** Couldn't read from entry 1 of a list which is empty ***
What do you want to craft with?

* * *

>craft band
*** Couldn't read from entry 1 of a list which is empty ***

*** Run-time problem P50: Attempt to use list item which does not exist.

*** Couldn't read from entry 1 of a list which is empty ***
(first taking the rubber band)
You can't craft *** Couldn't read from entry 1 of a list which is empty ***
nothing and *** Couldn't read from entry 2 of a list which is empty ***
nothing into anything useful.

* * *

>craft
What do you want to craft?

>craft stick
(first taking the Y-shaped wooden stick)
What do you want to craft with?

>craft stick, band
Y-shaped wooden stick: You now have a slingshot.
rubber band: That isn't available.

* * *

>talk to casper
Casper: "Maybe something on that table can help you out."

>look at table
A nice, sturdy table made of wood. You knock on it for good luck.

On the old table are jagged stone, a suspicious pair of glasses, a rubber band and a strange potion.

>take rubber band
Taken.

>talk to casper
Casper: "Looks like something fell out of the net... Go check it out, I'm sure it will be useful somewhere..."

>take jagged stone
Taken.

* * *

>take band
Taken.

>talk to casper
Casper: "There should be a stick somewhere around here... You could definitely craft a slingshot if you found it and combined it with that rubber band you have."

* * *

>craft stick with band
(first taking the Y-shaped wooden stick)
(first taking the rubber band)
You now have a slingshot.

>talk to casper
Casper: "Great work crafting that slingshot! You should be able to shoot down something in here... Look around!"

>shoot suspended net
(with the slingshot)
You picked up a nearby rock and shot the suspended net. The suspended net plummeted to the ground, along with a stone slab.

>talk to casper
Casper: "Looks like something fell out of the net... Go check it out, I'm sure it will be useful somewhere..."

>look at broken wall
A wall that appears to have several holes in it. It looks like there are four places that something may fit into.

>talk to casper
Casper: "Looks like something fell out of the net... Go check it out, it might fit in the broken wall from earlier..."

>look
Challenge Room 3
The room is filled with a variety of objects. A sense of dread comes over you as you look around. Where should you start?

You can see stone slab, a torn net, an old chest (closed), an old table (on which are jagged stone, a suspicious pair of glasses and a strange potion), a stack of boulders, a magical staff, a broken wall and Ghost here.

>take stone slab
Taken.

>talk to casper
Casper: "Maybe this oddly shaped stone will fit into the broken wall from earlier..."

>place stone slab in broken wall
The stone slab seemed to fit perfectly into the broken wall. You hear a faint clicking sound.

* * *

>talk to casper
Casper: "Maybe something on that table can help you out."

>talk to casper
Casper: "Maybe something on that table can help you out."

>look at table
A nice, sturdy table made of wood. You knock on it for good luck.

On the old table are jagged stone, a suspicious pair of glasses and a strange potion.

>look at chest
An old chest that looks like it might contain a pirate's treasure.

>talk to casper
Casper: "Maybe something on that table can help you out."

>look
Challenge Room 3
The room is filled with a variety of objects. A sense of dread comes over you as you look around. Where should you start?

You can see a torn net, an old chest (closed), an old table (on which are jagged stone, a suspicious pair of glasses and a strange potion), a stack of boulders, a magical staff, a broken wall and Ghost here.

>take jagged stone
Taken.

>talk to casper
Casper: "That stone might fit into that broken wall you saw earlier. You should try to place it into it!"

>place stone in broken wall
You can't see any such thing.

>place jagged stone in broken wall
The jagged stone seemed to fit perfectly into the broken wall. You hear a faint clicking sound.

>talk to casper
Casper: "Great, that fit perfectly!"

* * *

>talk to casper
Casper: "Maybe something on that table can help you out."

>look at table
A nice, sturdy table made of wood. You knock on it for good luck.

On the old table are a suspicious pair of glasses and a strange potion.

>take glasses
Taken.

>talk to casper
Casper: "Fancy glasses you've got there! You should wear them! I think you'd look great in it."

>wear glasses
There now appears to be a key on the old table.

>talk to casper
Casper: "Hey does that help your vision at all? Are you able to see anything new?"

>look at glasses
A pair of glasses that seems to be exuding a magical aura.

>talk to casper
Casper: "Hey does that help your vision at all? Are you able to see anything new?"

>take key
Taken.

>talk to casper
Casper: "Fancy key you found, looks like it's made out of pure gold. Maybe it unlocks a fancy chest!"

>unlock chest
What do you want to unlock the old chest with?

>key
In the old chest is a broken stone.

>talk to casper
Casper: "Was there nothing but a rock inside that chest all along? What a shame."

>take broken stone
Taken.

>talk to casper
Casper: "Maybe that useless rock fits into that broken wall from earlier."

>place broken stone in broken wall
The broken stone seemed to fit perfectly into the broken wall. You hear a faint clicking sound.

>talk to casper
Casper: "Great, that fit perfectly!"

* * *

>talk to casper
Casper: "Maybe something on that table can help you out."

>look at table
A nice, sturdy table made of wood. You knock on it for good luck.

On the old table is a strange potion.

>take strange potion
You can't see any such thing.

>take potion
Taken.

>talk to casper
Casper: "That lifting potion you have seems like it could help you with those heavy rocks... you should drink it!"

>look at potion
The potion looks suspicious, but you've drank swamp water before, so it can't be that bad.

>drink potion
You are now exuding a strange magical aura. It feels as if you can now lift things with ease.

>talk to casper
Casper: "Okay, you have the magical powers... But now you need a staff to channel those powers. I swear there was one lying around here somewhere..."

* * *

>take staff
Taken.

>talk to casper
Casper: "You have the staff and you drank the potion, right? Looks like you should be able to lift the rocks now!"

>lift rocks
You can't see any such thing.

>lift boulders
Despite consuming the lifting potion, the stack of boulders does not seem like it will move easily.

>talk to casper
Casper: "You have the staff and you drank the potion, right? Looks like you should be able to lift the rocks now!"

>lift boulders with staff
You channeled your newfound aura into the staff. To your surprise, the stack of boulders began to float in the air. Behind the stack of boulders was a stone shard. You moved the stack of boulders to the side, allowing access to the stone shard.

>talk to casper
Casper: "Looks like there was something behind the boulders... Go check it out, it might fit in the broken wall from earlier..."

>take stone shard
Taken.

>talk to casper
Casper: "Maybe this oddly shaped stone will fit into the broken wall from earlier..."

>place stone shard in broken wall
The stone shard seemed to fit perfectly into the broken wall. You hear a faint clicking sound.
With that last piece, you hear a strange sound behind you. You see a pedestal rising up from the ground, holding a blue gem.

>talk to casper
Casper: "Great, that fit perfectly!"

>talk to casper
Casper: "You solved the puzzle!! Go pick up the gem already..."

>take blue gem
Taken.

>talk to casper
Casper: "What are you still doing here, you already have the gem! Oh, are you worried that I'll be lonely here? Don't worry, I've been alone for years now. I'll eventually find something to do."

>talk to casper
Casper: "Well, if you want to stay here, then be my guest. Hmm, let's share stories. There was this one time where…"

>talk to casper
Casper: "Well, if you want to stay here, then be my guest. Hmm, let's share stories. There was this one time where…"

>i
You are carrying:
  a blue gem
  a magical staff
  a lifting potion
  an invisible key
  a pair of magic glasses (being worn)
  a slingshot

>put slingshot
What do you want to put the slingshot in?

>room
You can't see any such thing.

>put slingshot in wall
That can't contain things.

>put slingshot in challenge room 3
You can't see any such thing.

>put slingshot on the ground
You can't see any such thing.

>drop slingshot
Dropped.

* * *

>look at wall piece down
A piece of stone that appears to have broken off from somewhere.

* * *

>take stone
Taken.

>place stone in wall
The jagged stone seemed to fit perfectly into the broken wall. You hear a faint clicking sound.

>talk
(to Ghost)
Casper: "Great, that fit perfectly!"

* * *

>combine band with stick
(first taking the rubber band)
(first taking the Y-shaped wooden stick)
You now have a slingshot.

* * *

>use slingshot
(on the slingshot)
You picked up a nearby rock and shot the slingshot. The slingshot does not appear to be damaged.

>use slingshot on net
You picked up a nearby rock and shot the suspended net. The suspended net plummeted to the ground, along with a stone slab.

* * *

>use potion
There's nothing suitable to drink here.

>use strange potion
There's nothing suitable to drink here.

>use lifting potion
There's nothing suitable to drink here.

* * *

>look at wall
A wall that appears to have several holes in it. It looks like there are four places that something may fit into.

>take stone
Taken.

* * *

>place stone in wall
The jagged stone seemed to fit perfectly into the broken wall. You hear a faint clicking sound.

>look at wall
A wall that appears to have several holes in it. It looks like there are three places that something may fit into.

>combine band and stick
You can't use multiple objects with that verb.

* * *

>combine band with stick
(first taking the rubber band)
(first taking the Y-shaped wooden stick)
You now have a slingshot.

>shoot net with slingshot
You picked up a nearby rock and shot the suspended net. The suspended net plummeted to the ground, along with a stone slab.

* * *

>place slab in wall
The stone slab seemed to fit perfectly into the broken wall. You hear a faint clicking sound.

>look at wall
A wall that appears to have several holes in it. It looks like there are two places that something may fit into.

>wear glasses
(first taking the suspicious pair of glasses)
There is a strange aura coming from these glasses. When you put them on, a key appears on the old table.

* * *

>place broken stone in wall
The broken stone seemed to fit perfectly into the broken wall. You hear a faint clicking sound.

>look at wall
A wall that appears to have several holes in it. It looks like there is one place that something may fit into.

>drink elixir
You are now exuding a strange magical aura. It feels as if you can now lift things with ease.

* * *

>lift boulders with staff
You channeled your newfound aura into the staff. To your surprise, the stack of boulders began to float in the air. Behind the stack of boulders was a stone shard. You moved the stack of boulders to the side, allowing access to the stone shard.

>place shard in wall
The stone shard seemed to fit perfectly into the broken wall. You hear a faint clicking sound.
With that last piece, you hear a strange sound behind you. You see a pedestal rising up from the ground, holding a blue gem.

>look at wall
A wall that has been filled in with rocks that you found around this room.

>place key in wall
The invisible key does not seem to fit in the broken wall.

>look at wall
A wall that has been filled in with rocks that you found around this room.

* * *

>go west
Challenge Room 2 South
You find yourself in a damp and smelly room; the air suffocates you. To the east is an open archway that leads to an open area. To the west is a door to what looks like a closet.

To the north, there are man-eating vines that block a trench. There appears to be something shiny on the other side. The walls are lined with torches for light. And in the middle of the room stands a janitor feeding raw chicken to the vines.

>grab torch
Taken.

>use
(the wall torch on the wall torch)
You cannot use wall torch on wall torch.

Nothing happened.

>use torch on vines
You cannot use wall torch on man-eating vines.

Nothing happened.

>look
Challenge Room 2 South
You find yourself in a damp and smelly room; the air suffocates you. To the east is an open doorway that leads to an open area. To the west is a door to what looks like a closet.

To the north, there are man-eating vines that block a trench. There appears to be something shiny on the other side. The walls are lined with torches for light. And in the middle of the room stands a janitor feeding raw chicken to the vines.

>take torch
You already have that.

>go west
Supply Closet
You can see the suspicious broom here.

>ignite broom with torch
suspicious broom is not flammable.

Janitor: Hey, what are you doing?! Get out of there before you get burned as well!
The suspicious broom has been burnt to a crisp.

>look
Supply Closet

* * *

>go west
Challenge Room 2 South
You find yourself in a damp and smelly room; the air suffocates you. To the east is an open archway that leads to an open area. To the west is a door to what looks like a closet.

To the north, there are man-eating vines that block a trench. There appears to be something shiny on the other side. The walls are lined with torches for light. And in the middle of the room stands a janitor feeding raw chicken to the vines.

>go west
Supply Closet
There are a variety of cleaning supplies in this room. To the east is a door leading back to the musty room.

You can see the suspicious broom here.

>go east
Challenge Room 2 South
To the north, there are man-eating vines that block a trench. There appears to be something shiny on the other side. The walls are lined with torches for light. And in the middle of the room stands a janitor feeding raw chicken to the vines.

>take torch
Taken.

>go west
Supply Closet
You can see the suspicious broom here.

>ignite broom with torch
suspicious broom is not flammable.

>look
Supply Closet
You can see the suspicious broom here.

* * *

>go east
Challenge Room 2 South
To the north, there are man-eating vines that block a trench. There appears to be something shiny on the other side. The walls are lined with torches for light. And in the middle of the room stands a janitor feeding raw chicken to the vines.

>fly on broom
As you approach the man-eating vines, a shiver goes down your entire body. You decide against flying across.

>look
Challenge Room 2 South
You find yourself in a damp and smelly room; the air suffocates you. To the east is an open doorway that leads to an open area. To the west is a door to what looks like a closet.

To the north, there are man-eating vines that block a trench. There appears to be something shiny on the other side. The walls are lined with torches for light. And in the middle of the room stands a janitor feeding raw chicken to the vines.

>use torch and torch
You can't use multiple objects with that verb.

* * *

>take broom
Taken.

>use broom
You are unable to do anything with the broom.

>go east
Challenge Room 2 South
You find yourself in a damp and smelly room; the air suffocates you. To the east is an open archway that leads to an open area. To the west is a door to what looks like a closet.

To the north, there are man-eating vines that block a trench. There appears to be something shiny on the other side. The walls are lined with torches for light. And in the middle of the room stands a janitor feeding raw chicken to the vines.

>use broom
You are unable to do anything with the broom.

>look at broom
On the broom is a metal tag. It reads, "Nimbus 2000 (property of Hogwarts)." It's an older model, so nobody will miss it if you take it.

>use broom
As you approach the man-eating vines, a shiver goes down your entire body. You decide against flying across.

>use torch on vines
Janitor: Hey, what are you doing?! Get out of there before you get burned as well!
The man-eating vines has been burnt to a crisp.

>go east
Central Room
A rather barren room. You see a wizard at the north end next to what appears to be an exit. There are archways to your south, east, and west that seem to lead to rooms.

You can see a Wizard here.

* * *

>wear glasses
(first taking the suspicious pair of glasses)
There is a strange aura coming from these glasses. When you put them on, a key appears on the old table.

* * *

>take key
Taken.

>use key
You are unable to do anything with the invisible key

>use key on chest
In the old chest is a broken stone.

* * *

>help
Here are some commands to get you started.
go [cardinal direction] - Allows you to travel to a room in the specified cardinal direction.
look - Allows you to obtain a description of the room.
look at [something] - Allows you to examine something more closely.
take [something] - Allows you to put an item into your inventory.
inventory - Allows you to view the items in your possession.
talk to [someone] - Allows you to speak with a non-playable character.

There are other supported actions that you will come across during the game. Try out anything that comes to mind! To bring this message back up in the future, type help.

>go east
Challenge Room 3
You enter a room filled with a variety of objects. A sense of dread comes over you as you look around. Where should you start?

You can see an old chest (closed), an old table (on which are jagged stone, a suspicious pair of glasses, a rubber band and a strange potion), a Y-shaped wooden stick, a stack of boulders, a magical staff, a suspended net, broken wall and Ghost here.

Voice: "Here there! You probably can't see me as I'm a ghost, but my name's Casper! I was stuck in this room and died. Now that I have loads of free time, I figured out the puzzle. Or at least I think I did. Talk to me if you need any pointers!"

>take stick
Taken.

>talk to casper
Casper: "Looks like something fell out of the net... Go check it out, I'm sure it will be useful somewhere..."

>i
You are carrying:
  a Y-shaped wooden stick

* * *

>go west
Central Room
A rather barren room. You see a wizard at the north end next to what appears to be an exit. There are archways to your south, east, and west that seem to lead to rooms.

You can see a Wizard here.

* * *

>inventory
You are carrying nothing.

>talk to wizard
Wizard: "Welcome to my magnificent escape room! You have been randomly chosen from an infinite number of universes, lucky you! To escape, you must go into the rooms to your south, east, and west. In each of those rooms is a gem that you must obtain. But, it's not that simple; the gems can only be acquired through a series of puzzles. Good luck! Oh, there are also some people inside the rooms. Maybe they'll say something useful if you talk to them."

* * *

>take stick
You can't see any such thing.

>go east
Challenge Room 3
You enter a room filled with a variety of objects. A sense of dread comes over you as you look around. Where should you start?

You can see an old chest (closed), an old table (on which are jagged stone, a suspicious pair of glasses, a rubber band and a strange potion), a Y-shaped wooden stick, a stack of boulders, a magical staff, a suspended net, a broken wall and Ghost here.

Voice: "Here there! You probably can't see me as I'm a ghost, but my name's Casper! I was stuck in this room and died. Now that I have loads of free time, I figured out the puzzle. Or at least I think I did. Talk to me if you need any pointers!"

>take stick
Taken.

>take rubber
Taken.

>craft slingshot
You can't see any such thing.

>craft stick and rubber
You can't use multiple objects with that verb.

>talk to casper
Casper: "Have you tried crafting a slingshot using that stick and rubber band you have?"

>craft stick with rubber
You now have a slingshot.

>talk to casper
Casper: "Why'd you drop that Y-shaped stick and rubber band? You could definitely craft a slingshot if you picked them back up."