NPC Dialogue Tutorialization
An Interactive Fiction by Alexander Garcia
Release 1 / Serial number 210517 / Inform 7 build 6M62 (I6/v6.33 lib 6/12N) SD

Challenge Room 1
You can see the experimentation table (on which are the potion tray (in which are the red vial, the yellow vial, the blue vial, the white vial, the black vial and the clear vial), the recipe book and a beaker (empty)) and the broken vial here.

>go north
Exit Room

>go east
Challenge Room 3
You can see Wall Piece Right, Wall Piece Up, a locked chest (closed), an old table (on which are Wall Piece Down, an invisible key, a rubber band and a lifting potion), a Y-shaped wooden stick and a stack of pebbles here.

>go west
Exit Room

>go west
Challenge Room 2

>enter supply closet
You can't see any such thing.