NPC Dialogue Tutorialization
An Interactive Fiction by Alexander Garcia
Release 1 / Serial number 210601 / Inform 7 build 6M62 (I6/v6.33 lib 6/12N) SD

Challenge Room 1
You find yourself in a strange room. There is an open archway on the north side of the room, which seems to lead to an open area.

In this room, you see a table with a tray on it. Inside the tray are vials containing red, yellow, blue, black, white, and clear potions. Also on the table is a beaker and a recipe book. To the right is a stone encasing with a broken vial on the floor near it.

>mix red vial with blue vial
You now have a purple potion.

* * *

NPC Dialogue Tutorialization
An Interactive Fiction by Alexander Garcia
Release 1 / Serial number 210601 / Inform 7 build 6M62 (I6/v6.33 lib 6/12N) SD

Challenge Room 1
You find yourself in a strange room. There is an open archway on the north side of the room, which seems to lead to an open area.

In this room, you see a table with a tray on it. Inside the tray are vials containing red, yellow, blue, black, white, and clear potions. Also on the table is a beaker and a recipe book. To the right is a stone encasing with a broken vial on the floor near it.

>mix red potion with blue vial
I didn't understand that sentence.

>mix red vial with blue vial
You now have a purple potion.

>mix the red potion with blue vial
I didn't understand that sentence.

* * *

NPC Dialogue Tutorialization
An Interactive Fiction by Alexander Garcia
Release 1 / Serial number 210601 / Inform 7 build 6M62 (I6/v6.33 lib 6/12N) SD

Challenge Room 1
You find yourself in a strange room. There is an open archway on the north side of the room, which seems to lead to an open area.

In this room, you see a table with a tray on it. Inside the tray are vials containing red, yellow, blue, black, white, and clear potions. Also on the table is a beaker and a recipe book. To the right is a stone encasing with a broken vial on the floor near it.

>take red potion
I only understood you as far as wanting to take the red vial.

>mix red potion with blue vial
I didn't understand that sentence.

>brew red potion with blue vial
I didn't understand that sentence.

* * *

NPC Dialogue Tutorialization
An Interactive Fiction by Alexander Garcia
Release 1 / Serial number 210601 / Inform 7 build 6M62 (I6/v6.33 lib 6/12N) SD

Challenge Room 1
You find yourself in a strange room. There is an open archway on the north side of the room, which seems to lead to an open area.

In this room, you see a table with a tray on it. Inside the tray are vials containing red, yellow, blue, black, white, and clear potions. Also on the table is a beaker and a recipe book. To the right is a stone encasing with a broken vial on the floor near it.

>brew red potion with blue vial
You now have a purple potion.

>brew the red potion with blue vial
I didn't understand that sentence.

>brew the red potion with the blue vial
I didn't understand that sentence.

>brew the red vial with blue vial
You now have a purple potion.

>take red vial
Taken.

>take red potion
I only understood you as far as wanting to take the red vial.

* * *

>brew red potion with blue vial
You now have a purple potion.

>take red potion
Taken.

* * *

NPC Dialogue Tutorialization
An Interactive Fiction by Alexander Garcia
Release 1 / Serial number 210601 / Inform 7 build 6M62 (I6/v6.33 lib 6/12N) SD

Challenge Room 1
You find yourself in a strange room. There is an open archway on the north side of the room, which seems to lead to an open area.

In this room, you see a table with a tray on it. Inside the tray are vials containing red, yellow, blue, black, white, and clear potions. Also on the table is a beaker and a recipe book. To the right is a stone encasing with a broken vial on the floor near it.

>mix red potion with blue potion
You now have a purple potion.

>take purple potion
Taken.

>pour purple potion on stone encasing
NPC: AH! What are you doing?! Wait… I'm free! Thank you! But I would've preferred if you had given me a warning first.

* * *

>take purple potion
Taken.

>pour purple potion on npc
NPC: AH! What are you doing?! Wait… I'm free! Thank you! But I would've preferred if you had given me a warning first.