NPC Dialogue Tutorialization
An Interactive Fiction by Alexander Garcia
Release 1 / Serial number 210601 / Inform 7 build 6M62 (I6/v6.33 lib 6/12N) SD

Challenge Room 1
You find yourself in a strange room. There is an open archway on the north side of the room, which seems to lead to an open area.

In this room, you see a table with a tray on it. Inside the tray are vials containing red, yellow, blue, black, white, and clear potions. Also on the table is a beaker and a recipe book. To the right is a stone encasing with a broken vial on the floor near it.

>go north
Exit Room
You can see a formidable gate here.

>go west
Challenge Room 2 South
You enter a damp and smelly room; the air suffocates you. To the east is an open doorway that leads to an open area. To the west is a door to what looks like a closet.

To the north, there are man-eating vines that block a trench. There appears to be something shiny on the other side. The walls are lined with torches for light. And in the middle of the room stands a janitor feeding raw chicken to the vines.

>go east
Exit Room
You can see a formidable gate here.

>go east
Challenge Room 3
You enter a room filled with a variety of objects. A sense of dread comes over you as you look around. Where should you start?

You can see an old chest (closed), an old table (on which are jagged stone, a suspicious pair of glasses, a rubber band and a strange potion), a Y-shaped wooden stick, a stack of boulders, a magical staff, a suspended net and a broken wall here.

>take suspicious pair of glasses
Taken.

>pick up suspicious pair of glasses
You already have that.

>put suspicious pair of glasses on table
You put the suspicious pair of glasses on the old table.

>pick up suspicious pair of glasses
Taken.

* * *

>go north
Exit Room
You can see a formidable gate here.

>go east
Challenge Room 3
You enter a room filled with a variety of objects. A sense of dread comes over you as you look around. Where should you start?

You can see an old chest (closed), an old table (on which are jagged stone, a suspicious pair of glasses, a rubber band and a strange potion), a Y-shaped wooden stick, a stack of boulders, a magical staff, a suspended net, a broken wall and Ghost here.

Voice: "Here there! You probably can't see me as I'm a ghost, but my name's Casper! I was stuck in this room and died. Now that I have loads of free time, I figured out the puzzle. Or at least I think I did. Talk to me if you need any pointers!"

>take wall piece down
Taken.

>look at broken wall
A wall that appears to have several holes in it. It looks like there are four places that something may fit into.

>look
Challenge Room 3
You enter a room filled with a variety of objects. A sense of dread comes over you as you look around. Where should you start?

You can see an old chest (closed), an old table (on which are a suspicious pair of glasses, a rubber band and a strange potion), a Y-shaped wooden stick, a stack of boulders, a magical staff, a suspended net and a broken wall here.

>inventory
You are carrying:
  jagged stone

>place jagged stone
You can't see any such thing.

>place jagged stone in broken wall
You can't see any such thing.

>look at jagged stone
You can't see any such thing.

>wear glasses
(first taking the suspicious pair of glasses)
There now appears to be a key on the old table.

* * *

>take key
Taken.

>unlock chest
What do you want to unlock the old chest with?

>key
You unlock the old chest.

>open chest
You open the old chest, revealing broken stone.

>take broken stone
I only understood you as far as wanting to take the broken wall.

* * *

>take jagged stone
Taken.

>place jagged stone
(in jagged stone)
There is no space to place the jagged stone on the jagged stone

>place jagged stone in broken wall
The jagged stone seemed to fit perfectly into the broken wall. You hear a faint clicking sound.

* * *

>look at ghost
You see nothing special about Ghost.

* * *

>look
Challenge Room 3
The room is filled with a variety of objects. A sense of dread comes over you as you look around. Where should you start?

You can see an old chest (closed), an old table (on which are jagged stone, a suspicious pair of glasses, a rubber band and a strange potion), a Y-shaped wooden stick, a stack of boulders, a magical staff, a suspended net, a broken wall and Ghost here.

>go south
You can't go that way.

>go west
Exit Room
You can see a formidable gate here.

>go east
Challenge Room 3
You can see an old chest (closed), an old table (on which are jagged stone, a suspicious pair of glasses, a rubber band and a strange potion), a Y-shaped wooden stick, a stack of boulders, a magical staff, a suspended net, a broken wall and Ghost here.

* * *

>look
Challenge Room 3
The room is filled with a variety of objects. A sense of dread comes over you as you look around. Where should you start?

You can see an old chest (closed), an old table (on which are jagged stone, a suspicious pair of glasses, a rubber band and a strange potion), a Y-shaped wooden stick, a stack of boulders, a magical staff, a suspended net, a broken wall and Ghost here.

>go west
Exit Room
You can see a formidable gate here.

* * *

>talk to ghost
Maybe something on that table can help you out.

>look at table
A nice, sturdy table made of wood. You knock on it for good luck.

On the old table are jagged stone, a suspicious pair of glasses, a rubber band and a strange potion.

>talk to ghost
a

>take jagged stone
Taken.

>talk to ghost
Why are you asking me what to do? Place it in the wall, dummy!

* * *

>look at table
A nice, sturdy table made of wood. You knock on it for good luck.

On the old table are jagged stone, a suspicious pair of glasses, a rubber band and a strange potion.

>take glasses
Taken.

>talk to ghost
Fancy glasses you've got there! You should wear them! I think you'd look great in it.

>put glasses on table
You put the suspicious pair of glasses on the old table.

>talk to ghost
Where did you put those glasses from earlier? I want to see you wear them! I think you'd look great in it.