NPC Dialogue Tutorialization
An Interactive Fiction by Alexander Garcia
Release 1 / Serial number 210529 / Inform 7 build 6M62 (I6/v6.33 lib 6/12N) SD

Challenge Room 1
You find yourself in a strange room. There is an open archway on the north side of the room, which seems to lead to an open area.

In this room, you see a table with a tray on it. Inside the tray are vials containing red, yellow, blue, black, white, and clear potions. Also on the table is a beaker and a recipe book. To the right is a stone encasing with a broken vial on the floor near it.

>go north
Exit Room
You can see a formidable gate here.

>go east
Challenge Room 3
You can see an old chest (closed), an old table (on which are Wall Piece Down, a pair of magic glasses, a rubber band and a lifting potion), a Y-shaped wooden stick, a stack of boulders, a magical staff, a suspended net and a broken wall here.

>go west
Exit Room
You can see a formidable gate here.

>go west
Challenge Room 2 South
You can see a trench, a wall torch and a man-eating vines here.

>enter supply closet
You can't see any such thing.

>enter the Supply Closet
You can't see any such thing.

>go inside
Supply Closet
You can see the suspicious broom here.

>go outside
Challenge Room 2

>go inside the supply closet
You can't see any such thing.

* * *

>go west
Challenge Room 2 South
You can see a trench, a wall torch and a man-eating vines here.

>burn vines with torch
The man-eating vines has been burnt to a crisp.

>go west
Supply Closet
You can see the suspicious broom here.

>take broom
Taken.

>go east
Challenge Room 2 South
You can see a trench and a wall torch here.

>ride broom
I didn't understand that sentence.

>fly on broom
Challenge Room 2 North
You can see a trench and the yellow pedestal (on which is the yellow gem) here.

You have flown into the north side of the room.

>look at gem
The gem that you need from this room. It's on a nice looking pedestal. You wonder if you could also take the pedestal with you.

>take gem
Taken.

>look at yellow gem
The yellow gem that you need to escape. It's vibrancy reminds you of the sun.

* * *

>go east
Challenge Room 3
You can see an old chest (closed), an old table (on which are Wall Piece Down, a pair of magic glasses, a rubber band and a lifting potion), a Y-shaped wooden stick, a stack of boulders, a magical staff, a suspended net and a broken wall here.

>take y-shaped wooden stick
Taken.

>take rubber band
Taken.

>craft y-shaped wooden stick, rubber band together
Y-shaped wooden stick: rubber band: That isn't available.

>craft y-shaped wooden stick and rubber band together
You can't see any such thing.

* * *

>go east
Challenge Room 3
You can see an old chest (closed), an old table (on which are Wall Piece Down, a pair of magic glasses, a rubber band and a lifting potion), a Y-shaped wooden stick, a stack of boulders, a magical staff, a suspended net and a broken wall here.

>take rubber band
Taken.

>take y-shaped wooden stick
Taken.

>combine rubber band with y-shaped wooden stick
You now have a slingshot.

>inventory
You are carrying:
  a slingshot

>combine slingshot with slingshot
You can't combine the slingshot and the slingshot into anything useful.

* * *

>go east
Challenge Room 3
You can see an old chest (closed), an old table (on which are Wall Piece Down, a pair of magic glasses, a rubber band and a lifting potion), a Y-shaped wooden stick, a stack of boulders, a magical staff, a suspended net and a broken wall here.

>craft rubber band and y-shaped wooden stick
You can't use multiple objects with that verb.

>take rubber band
Taken.

>take stick
Taken.

>craft rubber band and stick
You can't use multiple objects with that verb.

>combine rubber band with stick
You now have a slingshot.

* * *

>go east
Challenge Room 3
You can see an old chest (closed), an old table (on which are Wall Piece Down, a pair of magic glasses, a rubber band and a lifting potion), a Y-shaped wooden stick, a stack of boulders, a magical staff, a suspended net and a broken wall here.

>craft slingshot
You can't see any such thing.

>craft stick with rubber band
(first taking the Y-shaped wooden stick)
(first taking the rubber band)
You now have a slingshot.

>shoot suspended net with slingshot
You picked up a nearby rock and shot suspended net. suspended net plummeted to the ground, along with Wall Piece Right.

* * *

>go east
Challenge Room 3
You can see an old chest (closed), an old table (on which are Wall Piece Down, a pair of magic glasses, a rubber band and a lifting potion), a Y-shaped wooden stick, a stack of boulders, a magical staff, a suspended net and a broken wall here.

>craft stick with band
(first taking the Y-shaped wooden stick)
(first taking the rubber band)
You now have a slingshot.

>shoot net
(with the slingshot)
You picked up a nearby rock and shot the suspended net. The suspended net plummeted to the ground, along with Wall Piece Right.

>look around
You can't see any such thing.

>look
Challenge Room 3
You can see Wall Piece Right, a torn net, a locked chest (closed), an old table (on which are Wall Piece Down, an invisible key and a lifting potion), a stack of rocks and a magical staff here.

>take wall piece right
Taken.

>take down
(Wall Piece Down)
Taken.

>unlock chest
What do you want to unlock the locked chest with?

>incisible key
You can't see any such thing.

>invisible key
That's not a verb I recognise.

>unlock chest
What do you want to unlock the locked chest with?

>invisible key
(first taking the invisible key)
You unlock the locked chest.

>look in chest
You can't see inside, since the locked chest is closed.

>open chest
You open the locked chest, revealing Wall Piece Left.

>take left
Taken.

>take wall piece left
You already have that.

>inventory
You are carrying:
  Wall Piece Left
  an invisible key
  Wall Piece Down
  Wall Piece Right
  a slingshot

* * *

>go east
Challenge Room 3
You can see an old chest (closed), an old table (on which are Wall Piece Down, a pair of magic glasses, a rubber band and a lifting potion), a Y-shaped wooden stick, a stack of boulders, a magical staff, a suspended net and a broken wall here.

>drink potion
You are now exuding a strange magical aura. It feels as if you can now lift things with ease.

* * *

>go east
Challenge Room 3
You can see an old chest (closed), an old table (on which are Wall Piece Down, a pair of magic glasses, a rubber band and a lifting potion), a Y-shaped wooden stick, a stack of boulders, a magical staff, a suspended net and a broken wall here.

>lift boulders
The stack of boulders seems to be too heavy for you to lift by hand.

>lift boulders
Despite your best efforts, you are unable to lift the stack of boulders.

>drink potion
You are now exuding a strange magical aura. It feels as if you can now lift things with ease.

>lift boulders
The magical aura does not seem to have made lifting the stack of boulders any easier.

>take staff
Taken.

>lift boulders with staff
Behind the stack of boulders was Wall Piece Up. You moved the stack of boulders to the side, allowing access to Wall Piece Up.

* * *

>lift boulders
The stack of boulders seems to be too heavy for you to lift by hand.

>check rock status
You can't see any such thing.

>check value rock status
You can't see any such thing.

>value rock status
That's not a verb I recognise.

>rock status
That's not a verb I recognise.

* * *

>go east
Challenge Room 3
You can see an old chest (closed), an old table (on which are Wall Piece Down, a pair of magic glasses, a rubber band and a lifting potion), a Y-shaped wooden stick, a stack of boulders, a magical staff, a suspended net and a broken wall here.

>take staff
Taken.

>lift boulders with staff
Nothing happened.

>drink potion
You are now exuding a strange magical aura. It feels as if you can now lift things with ease.

>lift boulders with staff
You channeled your newfound aura into the staff. To your surprise, the stack of boulders began to float in the air. Behind the stack of boulders was Wall Piece Up. You moved the stack of boulders to the side, allowing access to Wall Piece Up.

>lift boulders with staff
After lifting the stack of boulders with the magical staff, you found nothing interesting. You decided to put the stack of boulders back down.

* * *

>go east
Challenge Room 3
You can see an old chest (closed), an old table (on which are Wall Piece Down, a pair of magic glasses, a rubber band and a lifting potion), a Y-shaped wooden stick, a stack of boulders, a magical staff, a suspended net and a broken wall here.

>take down
(Wall Piece Down)
Taken.

>take key
Taken.

>unlock chest
What do you want to unlock the locked chest with?

>key
You unlock the locked chest.

>open chest
You open the locked chest, revealing Wall Piece Left.

* * *

>take left
Taken.

>combine stick and band
You can't use multiple objects with that verb.

>craft stick and band
You can't use multiple objects with that verb.

>combine stick with band
(first taking the Y-shaped wooden stick)
(first taking the rubber band)
You now have a slingshot.

>shoot net
What do you want to shoot the suspended net with?

>slingshot
You picked up a nearby rock and shot the suspended net. The suspended net plummeted to the ground, along with Wall Piece Right.

>take right
Taken.

>take staff
Taken.

>drink potion
You are now exuding a strange magical aura. It feels as if you can now lift things with ease.

* * *

>lift boulders with staff
You channeled your newfound aura into the staff. To your surprise, the stack of boulders began to float in the air. Behind the stack of boulders was Wall Piece Up. You moved the stack of boulders to the side, allowing access to Wall Piece Up.

>take up
(Wall Piece Up)
Taken.

>inventory
You are carrying:
  Wall Piece Up
  a magical staff
  Wall Piece Right
  a slingshot
  Wall Piece Left
  an invisible key
  Wall Piece Down

>look
Challenge Room 3
You can see a torn net, a locked chest (empty), an old table (on which is a lifting potion), a stack of boulders and a broken wall here.

>place up in wall
Which do you mean, the broken wall, Wall Piece Up, Wall Piece Right, Wall Piece Left or Wall Piece Down?

>place up in broken wall
Wall Piece Up seemed to fit perfectly into the broken wall. You hear a faint clicking sound.

>place down in broken wall
Wall Piece Down seemed to fit perfectly into the broken wall. You hear a faint clicking sound.

>inventory
You are carrying:
  a magical staff
  Wall Piece Right
  a slingshot
  Wall Piece Left
  an invisible key

>place right in broken wall
Wall Piece Right seemed to fit perfectly into the broken wall. You hear a faint clicking sound.

>place left in broken wall
Wall Piece Left seemed to fit perfectly into the broken wall. You hear a faint clicking sound.
With that last piece, you hear a strange sound behind you. You see a pedestal rising up from the ground, holding a blue gem.

>look
Challenge Room 3
You can see a blue pedestal (on which is a blue gem), a torn net, a locked chest (empty), an old table (on which is a lifting potion), a stack of boulders and a broken wall here.

>take blue gem
Taken.

* * *

>go east
Challenge Room 3
You can see an old chest (closed), an old table (on which are Wall Piece Down, a pair of magic glasses, a rubber band and a lifting potion), a Y-shaped wooden stick, a stack of boulders, a magical staff, a suspended net and a broken wall here.

>wear glasses
(first taking the pair of magic glasses)
There now appears to be a key on the old table.

>look
Challenge Room 3
You can see a locked chest (closed), an old table (on which are an invisible key, Wall Piece Down, a rubber band and a lifting potion), a Y-shaped wooden stick, a stack of boulders, a magical staff, a suspended net and a broken wall here.

>take key
Taken.

* * *

>wear glasses
(first taking the pair of magic glasses)
There now appears to be a key on the old table.

>remove glasses
The key seems to have disappeared from sight.

>wear glasses
There now appears to be a key on the old table.

>take key
Taken.

* * *

>go north
Exit Room
You can see a formidable gate here.

>go west
Challenge Room 2 South
You walk into a damp and smelly room; the air suffocates you. To the east is an open doorway that leads to an open area. To the west is a door to what looks like a closet.

To the north, there are man-eating vines that block a trench. There appears to be something shiny on the other side. The walls are lined with torches for light. And in the middle of the room stands a janitor feeding raw chicken to the vines.

>take torch
Taken.

>ignite man-eating vines with torch
The the man-eating vines has been burnt to a crisp.

>look
Challenge Room 2

>look around
You can't see any such thing.

>look torch
You see nothing special about the wall torch.

>look vines
You can't see any such thing.

* * *

>take torch
Taken.

>burn vines
(with the wall torch)
The the man-eating vines has been burnt to a crisp.

>go inside
Supply Closet
You can see the suspicious broom here.

>take broom
Taken.

>go outside
Challenge Room 2 South
You can see a trench here.

>fly on broom
Challenge Room 2 North
You can see a trench and the yellow pedestal (on which is the yellow gem) here.

You cannot fly in here.

* * *

>go west
Challenge Room 2 South
You walk into a damp and smelly room; the air suffocates you. To the east is an open doorway that leads to an open area. To the west is a door to what looks like a closet.

To the north, there are man-eating vines that block a trench. There appears to be something shiny on the other side. The walls are lined with torches for light. And in the middle of the room stands a janitor feeding raw chicken to the vines.

>go inside
Supply Closet
You can see the suspicious broom here.

>go outside
Challenge Room 2 South
You can see a trench, a wall torch and a man-eating vines here.

>go inside the supply closet
You can't see any such thing.

>go inside
Supply Closet
You can see the suspicious broom here.

* * *

>take broom
Taken.

>go outside
Challenge Room 2 South
You can see a trench, a wall torch and a man-eating vines here.

>fly on broom
As you approach the man-eating vines, a shiver goes down your entire body. You decide against flying across.

>go north
(first opening the trench)
It seems to be locked.

>take torch
Taken.

>burn vines with torch
I only understood you as far as wanting to burn the man-eating vines.

>burn
What do you want to burn?

* * *

>go outside
Challenge Room 2 South
You can see a trench, a wall torch and a man-eating vines here.

>take torch
Taken.

>burn vines with torch
The the man-eating vines has been burnt to a crisp.

>fly on broom
Challenge Room 2 North
You can see a trench and the yellow pedestal (on which is the yellow gem) here.

You have flown into the north side of the room.

>take yellow gem
Taken.

>go south
(first opening the trench)
It seems to be locked.

>fly on broom
Challenge Room 2 South
You can see a trench here.

You have flown into the south side of the room.

>go west
You can't go that way.

>go east
Exit Room

>fly on broom
You cannot fly in here.

* * *

>go west
Challenge Room 2 South
You walk into a damp and smelly room; the air suffocates you. To the east is an open doorway that leads to an open area. To the west is a door to what looks like a closet.

To the north, there are man-eating vines that block a trench. There appears to be something shiny on the other side. The walls are lined with torches for light. And in the middle of the room stands a janitor feeding raw chicken to the vines.

>go east
Exit Room
You can see a formidable gate here.

>go north
(first opening the formidable gate)
It seems to be locked.

>go east
Challenge Room 3
You can see a locked chest (closed), an old table (on which are Wall Piece Down, a pair of magic glasses, a rubber band and a lifting potion), a Y-shaped wooden stick, a stack of boulders, a magical staff, a suspended net and a broken wall here.

* * *

>go west
Challenge Room 2 South
You walk into a damp and smelly room; the air suffocates you. To the east is an open doorway that leads to an open area. To the west is a door to what looks like a closet.

To the north, there are man-eating vines that block a trench. There appears to be something shiny on the other side. The walls are lined with torches for light. And in the middle of the room stands a janitor feeding raw chicken to the vines.

>go west
Supply Closet
You can see the suspicious broom here.

* * *

>take broom
Taken.

>go east
Challenge Room 2 South
You can see a trench, a wall torch and a man-eating vines here.

>burn vines with torch
The man-eating vines has been burnt to a crisp.

>fly on brom
You can't see any such thing.

>fly on broom
Challenge Room 2 North
You can see a trench and the yellow pedestal (on which is the yellow gem) here.

You have flown into the north side of the room.

>look at pedestal
The pedestal holds the gem that you need from this room. The pedestal looks quite nice as well. You wonder if you could also take the pedestal with you.

On the yellow pedestal is the yellow gem.

* * *

>go west
Challenge Room 2 South
You walk into a damp and smelly room; the air suffocates you. To the east is an open doorway that leads to an open area. To the west is a door to what looks like a closet.

To the north, there are man-eating vines that block a trench. There appears to be something shiny on the other side. The walls are lined with torches for light. And in the middle of the room stands a janitor feeding raw chicken to the vines.

>go north
You'd rather not join the food chain today.

>look at trench
You see nothing special about the trench.

* * *

>go north
You'd rather not join the food chain today.

>burn vines with torch
The man-eating vines has been burnt to a crisp.

>go north
There is no feasible way to get across this trench.

>go west
Supply Closet
You can see the suspicious broom here.

* * *

>take broom
Taken.

>go north
You can't go that way.

>go east
Challenge Room 2 South
There is a trench to the north. There appears to be something shiny on the other side. The walls are lined with torches for light. And in the middle of the room stands a janitor cleaning up the mess left by the vines.

>go north
You'd rather not join the food chain today.

>take vines
You can't see any such thing.

>go north
You'd rather not join the food chain today.

>inventory
You are carrying:
  the suspicious broom

* * *

>go west
Challenge Room 2 South
You walk into a damp and smelly room; the air suffocates you. To the east is an open doorway that leads to an open area. To the west is a door to what looks like a closet.

To the north, there are man-eating vines that block a trench. There appears to be something shiny on the other side. The walls are lined with torches for light. And in the middle of the room stands a janitor feeding raw chicken to the vines.

>burn vines with torch
The man-eating vines has been burnt to a crisp.

* * *

>take broom
Taken.

>go east
Challenge Room 2 South
There is a trench to the north. There appears to be something shiny on the other side. The walls are lined with torches for light. And in the middle of the room stands a janitor cleaning up the mess left by the vines.

>go north
There is no feasible way to get across this trench.

>look at broom
On the broom is a metal tag. It reads, "Nimbus 2000 (property of Hogwarts)." It's an older model, so nobody will miss it if you take it.

>go north
The trench is deep. If only there were a way to get across...

>fly on broom
Challenge Room 2 North
The air seems to be fresher here.

An expensive-looking pedestal sits in the middle of the room. A yellow gem sits on top of it. To the south is the trench that you flew over, leading to the exit.

You have flown into the north side of the room.

>fly on broom
Challenge Room 2 South
You walk into a damp and smelly room; the air suffocates you. To the east is an open doorway that leads to an open area. To the west is a door to what looks like a closet.

There is a trench to the north. There appears to be something shiny on the other side. The walls are lined with torches for light. And in the middle of the room stands a janitor cleaning up the mess left by the vines.

You have flown into the south side of the room.

>go east
Exit Room
You can see a formidable gate here.

>go south
Challenge Room 1
In this room, you see a table with a tray on it. Inside the tray are vials containing red, yellow, blue, black, white, and clear potions. Also on the table is a beaker and a recipe book. To the right is a stone encasing with a broken vial on the floor near it.

* * *

NPC Dialogue Tutorialization
An Interactive Fiction by Alexander Garcia
Release 1 / Serial number 210529 / Inform 7 build 6M62 (I6/v6.33 lib 6/12N) SD

Challenge Room 1
You find yourself in a strange room. There is an open archway on the north side of the room, which seems to lead to an open area.

In this room, you see a table with a tray on it. Inside the tray are vials containing red, yellow, blue, black, white, and clear potions. Also on the table is a beaker and a recipe book. To the right is a stone encasing with a broken vial on the floor near it.

>mix red vial and blue vial
You can't use multiple objects with that verb.

>mix
What do you want to mix?

>blend
You can't see any such thing.

>combine
What do you want to combine?

>connect
What do you want to connect?

>take red vial
Taken.

>take blue vial
Taken.

>mix red vial and blue vial
You can't use multiple objects with that verb.

>take beaker
Taken.

>inventory
You are carrying:
  a beaker
  a blue vial
  a red vial

>mix red vial and blue vial
You can't use multiple objects with that verb.

>brew
That's not a verb I recognise.

* * *

NPC Dialogue Tutorialization
An Interactive Fiction by Alexander Garcia
Release 1 / Serial number 210529 / Inform 7 build 6M62 (I6/v6.33 lib 6/12N) SD

Challenge Room 1
You find yourself in a strange room. There is an open archway on the north side of the room, which seems to lead to an open area.

In this room, you see a table with a tray on it. Inside the tray are vials containing red, yellow, blue, black, white, and clear potions. Also on the table is a beaker and a recipe book. To the right is a stone encasing with a broken vial on the floor near it.

>brew
What do you want to brew?

>brew red vial and blue vial
You can't use multiple objects with that verb.

>brew the red vial and the blue vial
You can't use multiple objects with that verb.

>take red vial
Taken.

* * *

>take blue vial
Taken.

>brew red vial and blue vial
You can't use multiple objects with that verb.

>brew red vial with blue vial
I didn't understand that sentence.

* * *

NPC Dialogue Tutorialization
An Interactive Fiction by Alexander Garcia
Release 1 / Serial number 210529 / Inform 7 build 6M62 (I6/v6.33 lib 6/12N) SD

Challenge Room 1
You find yourself in a strange room. There is an open archway on the north side of the room, which seems to lead to an open area.

In this room, you see a table with a tray on it. Inside the tray are vials containing red, yellow, blue, black, white, and clear potions. Also on the table is a beaker and a recipe book. To the right is a stone encasing with a broken vial on the floor near it.

>brew red vial with blue vial
You now have a purple potion.

>dump
That's not a verb I recognise.

* * *

>brew red vial with blue vial
You now have a purple potion.

>dump purple potion
The the purple potion fizzled away.

* * *

>brew red vial with blue vial
You now have a purple potion.

>use purple potion on stone encasing
The stone encasing fizzled away. A red gem is left in its place.

>take red gem
Taken.

>inventory
You are carrying:
  a red gem

* * *

NPC Dialogue Tutorialization
An Interactive Fiction by Alexander Garcia
Release 1 / Serial number 210529 / Inform 7 build 6M62 (I6/v6.33 lib 6/12N) SD

Challenge Room 1
You find yourself in a strange room. There is an open archway on the north side of the room, which seems to lead to an open area.

In this room, you see a table with a tray on it. Inside the tray are vials containing red, yellow, blue, black, white, and clear potions. Also on the table is a beaker and a recipe book. To the right is a stone encasing with a broken vial on the floor near it.

>brew red vial and blue vial
You can't use multiple objects with that verb.

>brew red vial with blue vial
You now have a purple potion.

>brew white vial with black vial
(first taking the white vial)
(first taking the black vial)
You can't mix the white vial and the black vial into anything useful.

* * *

>brew red vial with blue vial
You now have a purple potion.

>dump purple potion
the purple potion fizzled away.

* * *

NPC Dialogue Tutorialization
An Interactive Fiction by Alexander Garcia
Release 1 / Serial number 210529 / Inform 7 build 6M62 (I6/v6.33 lib 6/12N) SD

Challenge Room 1
You find yourself in a strange room. There is an open archway on the north side of the room, which seems to lead to an open area.

In this room, you see a table with a tray on it. Inside the tray are vials containing red, yellow, blue, black, white, and clear potions. Also on the table is a beaker and a recipe book. To the right is a stone encasing with a broken vial on the floor near it.

>brew red vial and red vial
You can't use multiple objects with that verb.

>brew red vial with red vial
(first taking the red vial)
You now have a suspicious potion.

>brew red vial with blue vial
(first taking the blue vial)
There is no space in the beaker for a new potion.

* * *

NPC Dialogue Tutorialization
An Interactive Fiction by Alexander Garcia
Release 1 / Serial number 210529 / Inform 7 build 6M62 (I6/v6.33 lib 6/12N) SD

Challenge Room 1
You find yourself in a strange room. There is an open archway on the north side of the room, which seems to lead to an open area.

In this room, you see a table with a tray on it. Inside the tray are vials containing red, yellow, blue, black, white, and clear potions. Also on the table is a beaker and a recipe book. To the right is a stone encasing with a broken vial on the floor near it.

>dump purple potion
You can't see any such thing.

>brew red vial with blue vial
You now have a purple potion.

>dump purple potion
The purple potion fizzled away.

>use
That's not a verb I recognise.

* * *

NPC Dialogue Tutorialization
An Interactive Fiction by Alexander Garcia
Release 1 / Serial number 210529 / Inform 7 build 6M62 (I6/v6.33 lib 6/12N) SD

Challenge Room 1
You find yourself in a strange room. There is an open archway on the north side of the room, which seems to lead to an open area.

In this room, you see a table with a tray on it. Inside the tray are vials containing red, yellow, blue, black, white, and clear potions. Also on the table is a beaker and a recipe book. To the right is a stone encasing with a broken vial on the floor near it.

>fly
That's not a verb I recognise.

* * *

NPC Dialogue Tutorialization
An Interactive Fiction by Alexander Garcia
Release 1 / Serial number 210529 / Inform 7 build 6M62 (I6/v6.33 lib 6/12N) SD

Challenge Room 1
You find yourself in a strange room. There is an open archway on the north side of the room, which seems to lead to an open area.

In this room, you see a table with a tray on it. Inside the tray are vials containing red, yellow, blue, black, white, and clear potions. Also on the table is a beaker and a recipe book. To the right is a stone encasing with a broken vial on the floor near it.

>brew red and blue
You can't use multiple objects with that verb.

>brew red with blue
You now have a purple potion.

>use potion on stone encasing
Which do you mean, the potion tray or the purple potion?

>use purple potion on stone encasing
The stone encasing fizzled away. A red gem is left in its place.

* * *

>take red gem
Taken.

>go north
Exit Room
You can see a formidable gate here.

>go east
Challenge Room 3
You can see a locked chest (closed), an old table (on which are Wall Piece Down, an invisible key, a magic glasses, a rubber band and a lifting potion), a Y-shaped wooden stick, a stack of boulders, a magical staff, a suspended net and a broken wall here.

>take down
(Wall Piece Down)
Taken.

* * *

>take key
Taken.

>unlock chest with key
You unlock the locked chest.

>open chest
You open the locked chest, revealing Wall Piece Left.

* * *

>take left
Taken.

>craft stick with band
(first taking the Y-shaped wooden stick)
(first taking the rubber band)
You now have a slingshot.

>shoot net with slingshot
You picked up a nearby rock and shot the suspended net. The suspended net plummeted to the ground, along with Wall Piece Right.

>take right
Taken.

* * *

>take up
(Wall Piece Up)
Taken.

>place up in broken wall
Wall Piece Up seemed to fit perfectly into the broken wall. You hear a faint clicking sound.

* * *

>place down in broken wall
Wall Piece Down seemed to fit perfectly into the broken wall. You hear a faint clicking sound.

>place left in broken wall
Wall Piece Left seemed to fit perfectly into the broken wall. You hear a faint clicking sound.

>place right in broken wall
Wall Piece Right seemed to fit perfectly into the broken wall. You hear a faint clicking sound.
With that last piece, you hear a strange sound behind you. You see a pedestal rising up from the ground, holding a blue gem.

>take gem
(the blue gem)
Taken.

>inventory
You are carrying:
  a blue gem
  a magical staff
  a slingshot
  an invisible key
  a red gem

>where are exits
That's not a verb I recognise.

>go
You'll have to say which compass direction to go in.

>go west
Exit Room
You can see a formidable gate here.

* * *

>go east
Challenge Room 2 South
You can see a trench and a wall torch here.

>fly on broom
Challenge Room 2 North
You can see a trench and the yellow pedestal (on which is the yellow gem) here.

You have flown into the north side of the room.

>take gem
(the yellow gem)
Taken.

>fly on broom
Challenge Room 2 South
You can see a trench and a wall torch here.

You have flown into the south side of the room.

>go east
Exit Room
You can see a formidable gate here.

>go north
(first opening the formidable gate)

Last Room
You can see a formidable gate here.

    *** The End ***

Would you like to RESTART, RESTORE a saved game, QUIT or UNDO the last command?

* * *

NPC Dialogue Tutorialization
An Interactive Fiction by Alexander Garcia
Release 1 / Serial number 210529 / Inform 7 build 6M62 (I6/v6.33 lib 6/12N) SD

Challenge Room 1
You find yourself in a strange room. There is an open archway on the north side of the room, which seems to lead to an open area.

In this room, you see a table with a tray on it. Inside the tray are vials containing red, yellow, blue, black, white, and clear potions. Also on the table is a beaker and a recipe book. To the right is a stone encasing with a broken vial on the floor near it.

>look
Challenge Room 1
You find yourself in a strange room.

>look at table
this is a table

On the experimentation table are the potion tray (in which are a red vial, a yellow vial, a blue vial, a white vial, a black vial and a clear vial), the recipe book and a beaker (empty).

>go north
Exit Room
You can see a formidable gate here.

>go south
Challenge Room 1
You can see the experimentation table (on which are the potion tray (in which are a red vial, a yellow vial, a blue vial, a white vial, a black vial and a clear vial), the recipe book and a beaker (empty)), the broken vial and the stone encasing here.

* * *

NPC Dialogue Tutorialization
An Interactive Fiction by Alexander Garcia
Release 1 / Serial number 210529 / Inform 7 build 6M62 (I6/v6.33 lib 6/12N) SD

Challenge Room 1
You find yourself in a strange room. There is an open archway on the north side of the room, which seems to lead to an open area.

In this room, you see a table with a tray on it. Inside the tray are vials containing red, yellow, blue, black, white, and clear potions. Also on the table is a beaker and a recipe book. To the right is a stone encasing with a broken vial on the floor near it.

>look table
On the experimentation table are the potion tray (in which are a red vial, a yellow vial, a blue vial, a white vial, a black vial and a clear vial), the recipe book and a beaker (empty).

>look red vial
You see nothing special about the red vial.

* * *

NPC Dialogue Tutorialization
An Interactive Fiction by Alexander Garcia
Release 1 / Serial number 210529 / Inform 7 build 6M62 (I6/v6.33 lib 6/12N) SD

Challenge Room 1
You find yourself in a strange room. There is an open archway on the north side of the room, which seems to lead to an open area.

In this room, you see a table with a tray on it. Inside the tray are vials containing red, yellow, blue, black, white, and clear potions. Also on the table is a beaker and a recipe book. To the right is a stone encasing with a broken vial on the floor near it.

>look tray
Some vials containing unknown liquids in a tray. Reminds you of potions class and how you almost failed because the teacher was a complete--

In the potion tray are a red vial, a yellow vial, a blue vial, a white vial, a black vial and a clear vial.

* * *

NPC Dialogue Tutorialization
An Interactive Fiction by Alexander Garcia
Release 1 / Serial number 210529 / Inform 7 build 6M62 (I6/v6.33 lib 6/12N) SD

Challenge Room 1
You find yourself in a strange room. There is an open archway on the north side of the room, which seems to lead to an open area.

In this room, you see a table with a tray on it. Inside the tray are vials containing red, yellow, blue, black, white, and clear potions. Also on the table is a beaker and a recipe book. To the right is a stone encasing with a broken vial on the floor near it.

>look recipe book
The recipe book contains several recipes scribbled into it. 
 Cure grey hair = black + white 
 Madness potion = red + black 
 Cure stone encasing = blue + red 
 Become invisible = yellow + blue 
 ??? = clear + anything 
 Injury cure = black + blue